"","date","change","deposits","withdrawals","balance"
"40",2005-08-04,2408,70829,68422,10443
"41",2005-08-05,-1652,6404,8056,8791
"42",2005-08-08,3362,9867,6505,12153
"43",2005-08-09,-3063,3928,6991,9090
"44",2005-08-10,-1624,9204,10829,7466
"45",2005-08-11,-1588,68533,70121,5878
"46",2005-08-12,-946,8009,8955,4932
"47",2005-08-15,2891,63613,60722,7823
"48",2005-08-16,4296,11030,6734,12119
"49",2005-08-17,-570,9482,10052,11549
"50",2005-08-18,2129,72357,70228,13678
"51",2005-08-19,1841,8702,6861,15519
"52",2005-08-22,4171,9819,5648,19690
"53",2005-08-23,-2647,3291,5938,17043
"54",2005-08-24,-3436,7621,11057,13607
"55",2005-08-25,-540,70599,71139,13067
"56",2005-08-26,-2689,5984,8674,10378
"57",2005-08-29,3517,11013,7497,13895
"58",2005-08-30,-4232,3446,7678,9663
"59",2005-08-31,-1860,36934,38794,7803
"60",2005-09-01,-2237,94613,96850,5566
"61",2005-09-02,900,27824,26924,6466
"62",2005-09-06,826,9812,8986,7292
"63",2005-09-07,-2143,6921,9064,5149
"64",2005-09-08,4178,78921,74742,9327
"65",2005-09-09,-2988,6629,9617,6339
"66",2005-09-12,3613,11087,7474,9952
"67",2005-09-13,487,7933,7445,10439
"68",2005-09-14,-3425,14777,18202,7014
"69",2005-09-15,32827,150290,117463,39841
"70",2005-09-16,8622,15202,6580,48463
"71",2005-09-19,6724,13173,6449,55187
"72",2005-09-20,14660,20900,6241,69847
"73",2005-09-21,2316,13416,11100,72163
"74",2005-09-22,-12832,62420,75251,59331
"75",2005-09-23,790,9282,8492,60121
"76",2005-09-26,2680,10840,8161,62801
"77",2005-09-27,-3078,4777,7855,59723
"78",2005-09-28,-2943,8779,11722,56780
"79",2005-09-29,-7273,66508,73780,49507
"80",2005-09-30,-14590,36966,51556,34917
"81",2005-10-03,-20937,20336,41273,13980
"82",2005-10-04,-5212,4405,9617,8768
"83",2005-10-05,2091,10092,8001,10859
"84",2005-10-06,7495,73419,65924,18354
"85",2005-10-07,-3929,6238,10167,14425
"86",2005-10-11,211,10913,10702,14636
"87",2005-10-12,-7623,5390,13013,7013
"88",2005-10-13,2190,67696,65506,9203
"89",2005-10-14,-781,8878,9659,8422
"90",2005-10-17,20149,43491,23341,28571
"91",2005-10-18,-2190,5146,7336,26381
"92",2005-10-19,-293,10767,11060,26088
"93",2005-10-20,4049,67447,63398,30137
"94",2005-10-21,-1536,7122,8657,28601
"95",2005-10-24,1199,10155,8956,29800
"96",2005-10-25,-3272,4561,7833,26528
"97",2005-10-26,-2674,8978,11652,23854
"98",2005-10-27,9505,74517,65013,33359
"99",2005-10-28,7284,15216,7932,40643
"100",2005-10-31,-695,40567,41262,39948
"101",2005-11-01,-16594,13474,30068,23354
"102",2005-11-02,3338,10676,7338,26692
"103",2005-11-03,-12758,71760,84518,13934
"104",2005-11-04,-2254,8657,10910,11680
"105",2005-11-07,-56,9835,9891,11624
"106",2005-11-08,-4047,3910,7957,7577
"107",2005-11-09,928,11849,10920,8505
"108",2005-11-10,8726,78416,69690,17231
"109",2005-11-14,6069,14747,8678,23300
"110",2005-11-15,-19577,62461,82038,3723
"111",2005-11-16,2746,15094,12349,6469
"112",2005-11-17,10746,78661,67915,17215
"113",2005-11-18,-1479,8299,9778,15736
"114",2005-11-21,1438,10137,8699,17174
"115",2005-11-22,-5377,3223,8600,11797
"116",2005-11-23,-7853,8776,16629,3944
"117",2005-11-25,7384,82396,75011,11328
"118",2005-11-28,2141,7437,5296,13469
"119",2005-11-29,-3712,5109,8821,9757
"120",2005-11-30,-4531,37716,42246,5226
"121",2005-12-01,10084,105626,95541,15310
"122",2005-12-02,-4228,26232,30460,11082
"123",2005-12-05,-1407,9606,11013,9675
"124",2005-12-06,-5156,3784,8940,4519
"125",2005-12-07,2499,9689,7190,7018
"126",2005-12-08,2585,80112,77526,9603
"127",2005-12-09,-251,6279,6530,9352
"128",2005-12-12,5233,11391,6158,14585
"129",2005-12-13,-6862,4310,11172,7723
"130",2005-12-14,4050,15366,11316,11773
"131",2005-12-15,23145,157360,134215,34918
"132",2005-12-16,8119,17101,8982,43037
"133",2005-12-19,4272,12559,8288,47309
"134",2005-12-20,-1746,5008,6753,45563
"135",2005-12-21,550,12982,12432,46113
"136",2005-12-22,-11499,67046,78546,34614
"137",2005-12-23,8035,9850,1814,42649
"138",2005-12-27,5552,12354,6802,48201
"139",2005-12-28,-6266,6619,12885,41935
"140",2005-12-29,-4170,70450,74621,37765
"141",2005-12-30,-1903,14733,16636,35862
"142",2006-01-03,-18335,68792,87127,17527
"143",2006-01-04,103,9768,9664,17630
"144",2006-01-05,-5441,67400,72841,12189
"145",2006-01-06,1224,8232,7009,13413
"146",2006-01-09,4099,11002,6903,17512
"147",2006-01-10,-1370,6465,7836,16142
"148",2006-01-11,-2307,9798,12105,13835
"149",2006-01-12,-8345,62700,71046,5490
"150",2006-01-13,768,12321,11554,6258
"151",2006-01-17,25198,53332,28134,31456
"152",2006-01-18,5907,19697,13790,37363
"153",2006-01-19,3082,71587,68505,40445
"154",2006-01-20,2930,10433,7504,43375
"155",2006-01-23,9443,16617,7174,52818
"156",2006-01-24,6547,13120,6573,59365
"157",2006-01-25,211,11707,11496,59576
"158",2006-01-26,1916,71765,69849,61492
"159",2006-01-27,-4926,9603,14529,56566
"160",2006-01-30,5284,13301,8017,61850
"161",2006-01-31,6239,47773,41533,68089
"162",2006-02-01,-13520,20784,34304,54569
"163",2006-02-02,10399,77904,67506,64968
"164",2006-02-03,-28984,8713,37697,35984
"165",2006-02-06,1879,10556,8678,37863
"166",2006-02-07,-5328,4122,9450,32535
"167",2006-02-08,-3149,9222,12372,29386
"168",2006-02-09,4829,71049,66220,34215
"169",2006-02-10,-23024,7647,30672,11191
"170",2006-02-13,3612,11456,7844,14803
"171",2006-02-14,-1844,5554,7399,12959
"172",2006-02-15,3863,65233,61370,16822
"173",2006-02-16,15311,81317,66006,32133
"174",2006-02-17,-21189,6876,28064,10944
"175",2006-02-21,5631,13214,7584,16575
"176",2006-02-22,-8110,6058,14168,8465
"177",2006-02-23,11796,81941,70146,20261
"178",2006-02-24,-15642,7632,23274,4619
"179",2006-02-27,5009,13988,8979,9628
"180",2006-02-28,7717,52432,44715,17345
"181",2006-03-01,-12582,22210,34793,4763
"182",2006-03-02,6496,81765,75269,11259
"183",2006-03-03,-4330,34025,38355,6929
"184",2006-03-06,3441,12114,8673,10370
"185",2006-03-07,-4417,4403,8820,5953
"186",2006-03-08,3988,16355,12367,9941
"187",2006-03-09,6371,76836,70465,16312
"188",2006-03-10,-10077,8112,18190,6235
"189",2006-03-13,6487,14994,8507,12722
"190",2006-03-14,-2968,12519,15487,9754
"191",2006-03-15,4928,50468,45541,14682
"192",2006-03-16,16393,88620,72227,31075
"193",2006-03-17,-7852,6678,14530,23223
"194",2006-03-20,4201,10883,6683,27424
"195",2006-03-21,-3086,3791,6877,24338
"196",2006-03-22,-2892,9889,12782,21446
"197",2006-03-23,6745,81318,74573,28191
"198",2006-03-24,-8295,7219,15514,19896
"199",2006-03-27,4604,13235,8632,24500
"200",2006-03-28,-4905,3136,8041,19595
"201",2006-03-29,1573,10151,8578,21168
"202",2006-03-30,-4361,70679,75040,16807
"203",2006-03-31,-9372,54424,63795,7435
"204",2006-04-03,1322,42856,41534,8757
"205",2006-04-04,-2446,6412,8858,6311
"206",2006-04-05,1717,10821,9104,8028
"207",2006-04-06,-1295,71540,72835,6733
"208",2006-04-07,1486,16138,14651,8219
"209",2006-04-10,2965,12238,9273,11184
"210",2006-04-11,-394,9359,9753,10790
"211",2006-04-12,-1039,11294,12334,9751
"212",2006-04-13,-1014,74710,75724,8737
"213",2006-04-14,4250,19312,15062,12987
"214",2006-04-17,-559,67498,68058,12428
"215",2006-04-18,17006,24398,7392,29434
"216",2006-04-19,8383,20004,11621,37817
"217",2006-04-20,-20273,65307,85580,17544
"218",2006-04-21,2936,18003,15066,20480
"219",2006-04-24,15698,24009,8311,36178
"220",2006-04-25,32407,40487,8080,68585
"221",2006-04-26,8342,21433,13091,76927
"222",2006-04-27,-16721,66522,83243,60206
"223",2006-04-28,18035,32455,14420,78241
"224",2006-05-01,4963,77835,72872,83204
"225",2006-05-02,16243,23743,7500,99447
"226",2006-05-03,-11416,18522,29938,88031
"227",2006-05-04,-8529,65594,74122,79502
"228",2006-05-05,-1100,10755,11854,78402
"229",2006-05-08,3836,12575,8739,82238
"230",2006-05-09,-5578,4423,10001,76660
"231",2006-05-10,-3656,9135,12792,73004
"232",2006-05-11,-9062,62224,71286,63942
"233",2006-05-12,-298,8239,8537,63644
"234",2006-05-15,-39760,63273,103034,23884
"235",2006-05-16,3703,10983,7280,27587
"236",2006-05-17,-3844,8664,12508,23743
"237",2006-05-18,10,70224,70214,23753
"238",2006-05-19,-1163,8631,9793,22590
"239",2006-05-22,3386,11192,7806,25976
"240",2006-05-23,-4190,3296,7486,21786
"241",2006-05-24,-4330,7919,12249,17456
"242",2006-05-25,-3360,68013,71373,14096
"243",2006-05-26,641,8375,7734,14737
"244",2006-05-30,3278,10870,7592,18015
"245",2006-05-31,9299,51876,42577,27314
"246",2006-06-01,-19273,82153,101426,8041
"247",2006-06-02,-1736,30570,32307,6305
"248",2006-06-05,295,9971,9675,6600
"249",2006-06-06,3944,13187,9243,10544
"250",2006-06-07,3850,11103,7252,14394
"251",2006-06-08,-5539,68470,74010,8855
"252",2006-06-09,1342,7223,5882,10197
"253",2006-06-12,5904,12242,6338,16101
"254",2006-06-13,1388,7846,6458,17489
"255",2006-06-14,5071,16586,11515,22560
"256",2006-06-15,10783,130052,119269,33343
"257",2006-06-16,7896,17376,9481,41239
"258",2006-06-19,7389,15156,7767,48628
"259",2006-06-20,10866,22164,11298,59494
"260",2006-06-21,3608,14615,11007,63102
"261",2006-06-22,-14377,64312,78689,48725
"262",2006-06-23,2642,8336,5695,51367
"263",2006-06-26,6245,12360,6115,57612
"264",2006-06-27,-2374,4461,6835,55238
"265",2006-06-28,-2514,8902,11416,52724
"266",2006-06-29,-3810,68287,72096,48914
"267",2006-06-30,-3893,54290,58183,45021
"268",2006-07-03,-25426,23313,48739,19595
"269",2006-07-05,-2524,6159,8683,17071
"270",2006-07-06,-541,71796,72337,16530
"271",2006-07-07,-1194,6611,7805,15336
"272",2006-07-10,3646,9948,6302,18982
"273",2006-07-11,-3483,3475,6958,15499
"274",2006-07-12,-2422,8435,10857,13077
"275",2006-07-13,2052,64055,62002,15129
"276",2006-07-14,-696,10641,11337,14433
"277",2006-07-17,-603,36691,37294,13830
"278",2006-07-18,-2190,4550,6740,11640
"279",2006-07-19,16,10064,10048,11656
"280",2006-07-20,309,65929,65620,11965
"281",2006-07-21,-425,6256,6681,11540
"282",2006-07-24,4205,9940,5735,15745
"283",2006-07-25,-3567,3721,7288,12178
"284",2006-07-26,-2704,8898,11603,9474
"285",2006-07-27,3059,74558,71499,12533
"286",2006-07-28,-713,8546,9259,11820
"287",2006-07-31,25118,66264,41146,36938
"288",2006-08-01,-23567,13691,37258,13371
"289",2006-08-02,4544,11273,6729,17915
"290",2006-08-03,-13250,80395,93645,4665
"291",2006-08-04,1108,8699,7591,5773
"292",2006-08-07,3153,10125,6972,8926
"293",2006-08-08,-3418,3619,7037,5508
"294",2006-08-09,-2931,8574,11505,2577
"295",2006-08-10,5119,78130,73011,7696
"296",2006-08-11,-2252,6658,8910,5444
"297",2006-08-14,4128,12416,8288,9572
"298",2006-08-15,-6468,58836,65304,3104
"299",2006-08-16,4187,15473,11286,7291
"300",2006-08-17,7382,79596,72214,14673
"301",2006-08-18,2003,7915,5912,16676
"302",2006-08-21,5332,11533,6201,22008
"303",2006-08-22,-2964,3525,6489,19044
"304",2006-08-23,-3270,7898,11168,15774
"305",2006-08-24,-3676,77905,81581,12098
"306",2006-08-25,-2121,6989,9109,9977
"307",2006-08-28,4011,11312,7301,13988
"308",2006-08-29,-2209,5648,7857,11779
"309",2006-08-30,1109,7766,6658,12888
"310",2006-08-31,2790,124860,122070,15678
"311",2006-09-01,-11948,44763,56711,3730
"312",2006-09-05,4218,12307,8088,7948
"313",2006-09-06,-2320,7120,9439,5628
"314",2006-09-07,1297,84781,83484,6925
"315",2006-09-08,-1573,8305,9878,5352
"316",2006-09-11,3748,11823,8076,9100
"317",2006-09-12,-551,7291,7842,8549
"318",2006-09-13,-1090,10096,11185,7459
"319",2006-09-14,-1435,82436,83871,6024
"320",2006-09-15,34474,94590,60117,40498
"321",2006-09-18,15181,21602,6421,55679
"322",2006-09-19,13909,20562,6654,69588
"323",2006-09-20,5445,17176,11731,75033
"324",2006-09-21,-12282,68851,81134,62751
"325",2006-09-22,1901,10539,8638,64652
"326",2006-09-25,6235,14152,7917,70887
"327",2006-09-26,-517,6222,6738,70370
"328",2006-09-27,-1454,10619,12073,68916
"329",2006-09-28,-17028,62531,79558,51888
"330",2006-09-29,-519,13426,13945,51369
"331",2006-10-02,651,64756,64106,52020
"332",2006-10-03,-26038,4454,30492,25982
"333",2006-10-04,791,10749,9958,26773
"334",2006-10-05,-6937,58970,65906,19836
"335",2006-10-06,-1863,7775,9638,17973
"336",2006-10-10,1912,11454,9543,19885
"337",2006-10-11,-8716,6095,14811,11169
"338",2006-10-12,-206,61879,62085,10963
"339",2006-10-13,-1313,8837,10149,9650
"340",2006-10-16,2082,36024,33941,11732
"341",2006-10-17,-300,6141,6441,11432
"342",2006-10-18,2732,14972,12240,14164
"343",2006-10-19,9069,69658,60589,23233
"344",2006-10-20,-1198,8991,10189,22035
"345",2006-10-24,-969,5876,6845,21066
"346",2006-10-25,-1738,9892,11631,19328
"347",2006-10-26,8544,69469,60925,27872
"348",2006-10-27,728,8094,7366,28600
"349",2006-10-30,3474,10382,6908,32074
"350",2006-10-31,20241,59872,39631,52315
"351",2006-11-01,-17377,18655,36033,34938
"352",2006-11-02,13011,76390,63379,47949
"353",2006-11-03,-20851,9272,30123,27098
"354",2006-11-06,1969,10746,8777,29067
"355",2006-11-07,-5224,3661,8885,23843
"356",2006-11-08,-2714,9700,12414,21129
"357",2006-11-09,9623,74017,64395,30752
"358",2006-11-13,4313,9965,5652,35065
"359",2006-11-14,-2679,5943,8622,32386
"360",2006-11-15,-32992,71951,104943,-606
"361",2006-11-16,10387,83772,73385,9781
"362",2006-11-17,-2995,6477,9472,6786
"363",2006-11-20,1522,10838,9316,8308
"364",2006-11-21,-3909,4371,8280,4399
"365",2006-11-22,-3930,10323,14253,469
"366",2006-11-24,11728,84142,72414,12197
"367",2006-11-27,2189,7557,5368,14386
"368",2006-11-28,-5735,3433,9168,8651
"369",2006-11-29,2859,10721,7862,11510
"370",2006-11-30,3549,124859,121310,15059
"371",2006-12-01,-15347,45975,61323,-288
"372",2006-12-04,2072,12737,10666,1784
"373",2006-12-05,5619,14809,9190,7403
"374",2006-12-06,2757,10755,7998,10160
"375",2006-12-07,-5085,73151,78237,5075
"376",2006-12-08,319,6855,6536,5394
"377",2006-12-11,4436,11185,6749,9830
"378",2006-12-12,-3260,5146,8406,6570
"379",2006-12-13,-1113,11133,12246,5457
"380",2006-12-14,-6125,74940,81065,-668
"381",2006-12-15,40150,95172,55022,39482
"382",2006-12-18,13837,22253,8416,53319
"383",2006-12-19,-2045,5299,7344,51274
"384",2006-12-20,2606,13992,11386,53880
"385",2006-12-21,-15479,67618,83097,38401
"386",2006-12-22,3019,10436,7417,41420
"387",2006-12-26,7278,15311,8033,48698
"388",2006-12-27,-7143,6559,13702,41555
"389",2006-12-28,-14476,68588,83064,27079
"390",2006-12-29,-2256,15803,18060,24823
"391",2007-01-02,9305,75764,66459,34128
"392",2007-01-03,-19424,8422,27846,14704
"393",2007-01-04,-6933,67652,74585,7771
"394",2007-01-05,433,8699,8267,8204
"395",2007-01-08,4883,11980,7097,13087
"396",2007-01-09,982,8528,7546,14069
"397",2007-01-10,-2993,9396,12389,11076
"398",2007-01-11,-3663,60175,63839,7413
"399",2007-01-12,-516,11947,12462,6897
"400",2007-01-16,8156,44159,36003,15053
"401",2007-01-17,8491,21482,12990,23544
"402",2007-01-18,853,66359,65506,24397
"403",2007-01-19,4553,11319,6766,28950
"404",2007-01-22,13262,19604,6342,42212
"405",2007-01-23,11172,17727,6555,53384
"406",2007-01-24,2029,13217,11188,55413
"407",2007-01-25,-3271,62148,65418,52142
"408",2007-01-26,-6940,9018,15958,45202
"409",2007-01-29,11470,19132,7662,56672
"410",2007-01-30,-3107,4282,7389,53565
"411",2007-01-31,24417,62539,38121,77982
"412",2007-02-01,-17599,77240,94839,60383
"413",2007-02-02,-28633,9526,38159,31750
"414",2007-02-05,3303,11478,8174,35053
"415",2007-02-06,-3689,4901,8590,31364
"416",2007-02-07,3324,11070,7746,34688
"417",2007-02-08,7662,73829,66166,42350
"418",2007-02-09,-22157,7181,29338,20193
"419",2007-02-12,3153,12335,9182,23346
"420",2007-02-13,-4154,3555,7709,19192
"421",2007-02-14,-1677,10528,12206,17515
"422",2007-02-15,-8678,126271,134949,8837
"423",2007-02-16,-8693,22804,31497,144
"424",2007-02-20,7804,14953,7149,7948
"425",2007-02-21,-6224,6865,13089,1724
"426",2007-02-22,14792,91321,76529,16516
"427",2007-02-23,-15483,9440,24923,1033
"428",2007-02-26,5460,13934,8474,6493
"429",2007-02-27,-3261,5344,8605,3232
"430",2007-02-28,2435,52011,49577,5667
"431",2007-03-01,4708,103552,98844,10375
"432",2007-03-02,-10255,32885,43140,120
"433",2007-03-05,5014,13696,8681,5134
"434",2007-03-06,-1429,7500,8929,3705
"435",2007-03-07,3322,12004,8682,7027
"436",2007-03-08,8346,86872,78526,15373
"437",2007-03-09,-11669,8072,19741,3704
"438",2007-03-12,5914,15345,9432,9618
"439",2007-03-13,-4198,4461,8659,5420
"440",2007-03-14,1908,14858,12950,7328
"441",2007-03-15,19330,130506,111176,26658
"442",2007-03-16,2596,19881,17286,29254
"443",2007-03-19,4107,11349,7242,33361
"444",2007-03-20,-3058,4501,7559,30303
"445",2007-03-21,-1734,11569,13303,28569
"446",2007-03-22,-2911,83132,86043,25658
"447",2007-03-23,-8559,7885,16444,17099
"448",2007-03-26,3215,11951,8737,20314
"449",2007-03-27,-5613,4695,10308,14701
"450",2007-03-28,-5632,8905,14537,9069
"451",2007-03-29,-5016,80878,85893,4053
"452",2007-03-30,-3927,26721,30648,126
"453",2007-04-02,7758,63499,55741,7884
"454",2007-04-03,-7638,22279,29917,246
"455",2007-04-04,2447,11897,9450,2693
"456",2007-04-05,4585,87500,82915,7278
"457",2007-04-06,-6649,8941,15590,629
"458",2007-04-09,2611,11640,9029,3240
"459",2007-04-10,-1166,8245,9411,2074
"460",2007-04-11,2031,15585,13554,4105
"461",2007-04-12,-6143,75382,81526,-2038
"462",2007-04-13,8049,22279,14230,6011
"463",2007-04-16,-2403,42429,44832,3608
"464",2007-04-17,19485,58054,38570,23093
"465",2007-04-18,-4966,17217,22182,18127
"466",2007-04-19,-12778,68280,81058,5349
"467",2007-04-20,3886,19931,16044,9235
"468",2007-04-23,18607,26392,7785,27842
"469",2007-04-24,43609,51796,8187,71451
"470",2007-04-25,15637,29105,13468,87088
"471",2007-04-26,-11082,70112,81195,76006
"472",2007-04-27,6917,22580,15663,82923
"473",2007-04-30,34955,77797,42842,117878
"474",2007-05-01,-6988,33161,40149,110890
"475",2007-05-02,6880,15646,8766,117770
"476",2007-05-03,-39897,59053,98950,77873
"477",2007-05-04,-433,11812,12245,77440
"478",2007-05-07,1687,12563,10876,79127
"479",2007-05-08,-5198,4018,9216,73929
"480",2007-05-09,-3978,9764,13742,69951
"481",2007-05-10,-13361,56092,69453,56590
"482",2007-05-11,-1679,7191,8870,54911
"483",2007-05-14,4420,12631,8210,59331
"484",2007-05-15,-41810,57402,99212,17521
"485",2007-05-16,3174,16881,13707,20695
"486",2007-05-17,-5006,63811,68817,15689
"487",2007-05-18,-1472,9225,10697,14217
"488",2007-05-21,3629,11630,8002,17846
"489",2007-05-22,-4254,3922,8176,13592
"490",2007-05-23,-4654,8778,13432,8938
"491",2007-05-24,-982,69724,70705,7956
"492",2007-05-25,-44,7059,7103,7912
"493",2007-05-29,6385,13953,7568,14297
"494",2007-05-30,-3208,7159,10368,11089
"495",2007-05-31,9200,115505,106306,20289
"496",2007-06-01,-18212,46235,64447,2077
"497",2007-06-04,2580,12797,10217,4657
"498",2007-06-05,6379,15920,9540,11036
"499",2007-06-06,4706,11690,6983,15742
"500",2007-06-07,-8882,64706,73589,6860
"501",2007-06-08,675,7325,6649,7535
"502",2007-06-11,4995,11737,6742,12530
"503",2007-06-12,73,6566,6493,12603
"504",2007-06-13,-861,11865,12726,11742
"505",2007-06-14,-9034,70228,79262,2708
"506",2007-06-15,21528,77529,56001,24236
"507",2007-06-18,15093,22879,7786,39329
"508",2007-06-19,14456,22063,7607,53785
"509",2007-06-20,5454,17464,12010,59239
"510",2007-06-21,-16544,64583,81127,42695
"511",2007-06-22,4675,11374,6700,47370
"512",2007-06-25,7012,13389,6377,54382
"513",2007-06-26,-1318,5593,6911,53064
"514",2007-06-27,-2705,10924,13629,50359
"515",2007-06-28,-12412,64983,77395,37947
"516",2007-06-29,-18580,11588,30168,19367
"517",2007-07-02,8047,62895,54848,27414
"518",2007-07-03,-25014,5606,30621,2400
"519",2007-07-05,2156,71602,69445,4556
"520",2007-07-06,-954,7283,8236,3602
"521",2007-07-09,3963,11235,7272,7565
"522",2007-07-10,-3830,3437,7267,3735
"523",2007-07-11,-2156,10039,12194,1579
"524",2007-07-12,-994,61245,62239,585
"525",2007-07-13,-1773,10406,12179,-1188
"526",2007-07-16,18610,33910,15300,17422
"527",2007-07-17,-2872,4433,7304,14550
"528",2007-07-18,-1695,9740,11436,12855
"529",2007-07-19,2019,62239,60220,14874
"530",2007-07-20,-458,6447,6905,14416
"531",2007-07-23,4908,11086,6178,19324
"532",2007-07-24,-3262,3616,6879,16062
"533",2007-07-25,-3591,8912,12503,12471
"534",2007-07-26,9405,72067,62662,21876
"535",2007-07-27,-607,8676,9284,21269
"536",2007-07-30,3910,12259,8349,25179
"537",2007-07-31,16319,53329,37010,41498
"538",2007-08-01,-20730,19775,40505,20768
"539",2007-08-02,22434,86668,64234,43202
"540",2007-08-03,-18575,9509,28084,24627
"541",2007-08-06,3443,11180,7737,28070
"542",2007-08-07,-5044,3961,9005,23026
"543",2007-08-08,-3477,10041,13518,19549
"544",2007-08-09,22968,86842,63874,42517
"545",2007-08-10,-2543,6947,9491,39974
"546",2007-08-13,3751,11449,7698,43725
"547",2007-08-14,-1958,5539,7497,41767
"548",2007-08-15,-36440,83829,120268,5327
"549",2007-08-16,1785,92458,90673,7112
"550",2007-08-17,581,7159,6579,7693
"551",2007-08-20,4913,10844,5931,12606
"552",2007-08-21,-3295,3847,7142,9311
"553",2007-08-22,-943,10971,11914,8368
"554",2007-08-23,1600,85017,83416,9968
"555",2007-08-24,-2542,6346,8889,7426
"556",2007-08-27,3899,11729,7830,11325
"557",2007-08-28,-5931,2949,8880,5394
"558",2007-08-29,3181,9919,6738,8575
"559",2007-08-30,4815,87769,82953,13390
"560",2007-08-31,-9787,67091,76879,3603
"561",2007-09-04,-853,22794,23647,2750
"562",2007-09-05,-2570,7852,10422,180
"563",2007-09-06,5421,90071,84650,5601
"564",2007-09-07,-2918,7004,9922,2683
"565",2007-09-10,2807,11863,9056,5490
"566",2007-09-11,-1571,6481,8052,3919
"567",2007-09-12,-1094,11542,12636,2825
"568",2007-09-13,-337,81949,82286,2488
"569",2007-09-14,11821,20604,8783,14309
"570",2007-09-17,60360,95515,35156,74669
"571",2007-09-18,10344,17639,7295,85013
"572",2007-09-19,2758,15813,13054,87771
"573",2007-09-20,-15600,68524,84124,72171
"574",2007-09-21,5074,14515,9441,77245
"575",2007-09-24,9365,18613,9248,86610
"576",2007-09-25,335,10254,9919,86945
"577",2007-09-26,-2569,11110,13679,84376
"578",2007-09-27,-22256,59947,82203,62120
"579",2007-09-28,7274,16146,8871,69394
"580",2007-10-01,-10312,62894,73206,59082
"581",2007-10-02,-1121,5483,6604,57961
"582",2007-10-03,-17404,11774,29178,40557
"583",2007-10-04,-17714,59583,77297,22843
"584",2007-10-05,-3663,7185,10848,19180
"585",2007-10-09,3047,12481,9433,22227
"586",2007-10-10,-11815,5216,17032,10412
"587",2007-10-11,-7256,62248,69504,3156
"588",2007-10-12,-369,6980,7349,2787
"589",2007-10-15,14843,27898,13054,17630
"590",2007-10-16,3829,11579,7750,21459
"591",2007-10-17,-2767,10102,12869,18692
"592",2007-10-18,-7407,58178,65585,11285
"593",2007-10-19,300,10298,9998,11585
"594",2007-10-22,4642,13120,8478,16227
"595",2007-10-23,-1069,5977,7046,15158
"596",2007-10-24,-5020,8610,13629,10138
"597",2007-10-25,-190,64582,64772,9948
"598",2007-10-26,-996,6902,7897,8952
"599",2007-10-29,5208,13077,7869,14160
"600",2007-10-30,-4863,3563,8426,9297
"601",2007-10-31,22818,60104,37286,32115
"602",2007-11-01,-5142,89606,94749,26973
"603",2007-11-02,-21552,9358,30910,5421
"604",2007-11-05,1259,12004,10745,6680
"605",2007-11-06,-4748,4276,9023,1932
"606",2007-11-07,2714,10512,7798,4646
"607",2007-11-08,17829,84635,66805,22475
"608",2007-11-09,-407,6658,7065,22068
"609",2007-11-13,2164,12147,9983,24232
"610",2007-11-14,-6454,8588,15043,17778
"611",2007-11-15,-16006,139457,155463,1772
"612",2007-11-16,3608,14071,10463,5380
"613",2007-11-19,2102,11349,9247,7482
"614",2007-11-20,-3930,4177,8107,3552
"615",2007-11-21,-3656,11178,14834,-104
"616",2007-11-23,8590,91325,82735,8486
"617",2007-11-26,2687,9387,6700,11173
"618",2007-11-27,-4925,3096,8021,6248
"619",2007-11-28,-6319,8237,14556,-71
"620",2007-11-29,9969,91896,81928,9898
"621",2007-11-30,-7195,50713,57909,2703
"622",2007-12-03,4272,53760,49488,6975
"623",2007-12-04,-5268,4485,9752,1707
"624",2007-12-05,1579,10831,9252,3286
"625",2007-12-06,-708,85909,86617,2578
"626",2007-12-07,-627,6648,7274,1951
"627",2007-12-10,4182,11790,7607,6133
"628",2007-12-11,-4379,3759,8138,1754
"629",2007-12-12,3591,17548,13956,5345
"630",2007-12-13,-6145,80853,86998,-800
"631",2007-12-14,8340,21013,12673,7540
"632",2007-12-17,54687,104051,49364,62227
"633",2007-12-18,-2465,5622,8086,59762
"634",2007-12-19,-690,12012,12703,59072
"635",2007-12-20,-15868,67534,83402,43204
"636",2007-12-21,943,11132,10189,44147
"637",2007-12-24,12341,17409,5068,56488
"638",2007-12-26,-6267,5414,11681,50221
"639",2007-12-27,-20754,63624,84378,29467
"640",2007-12-28,1997,13268,11271,31464
"641",2007-12-31,19669,65252,45583,51133
"642",2008-01-02,-11095,25834,36930,40038
"643",2008-01-03,-36235,67356,103591,3803
"644",2008-01-04,1865,10802,8937,5668
"645",2008-01-07,3837,12126,8289,9505
"646",2008-01-08,-436,8030,8467,9069
"647",2008-01-09,-3012,10424,13437,6057
"648",2008-01-10,-3891,69528,73419,2166
"649",2008-01-11,-37,9269,9306,2129
"650",2008-01-14,8261,16488,8227,10390
"651",2008-01-15,-5890,33550,39440,4500
"652",2008-01-16,7538,20193,12655,12038
"653",2008-01-17,-9486,61462,70949,2552
"654",2008-01-18,9051,15702,6651,11603
"655",2008-01-22,15588,22673,7085,27191
"656",2008-01-23,11262,25842,14580,38453
"657",2008-01-24,1311,71698,70387,39764
"658",2008-01-25,-7825,12228,20053,31939
"659",2008-01-28,6389,14465,8077,38328
"660",2008-01-29,-2335,6151,8485,35993
"661",2008-01-30,2934,10047,7113,38927
"662",2008-01-31,25503,131913,106410,64430
"663",2008-02-01,-47995,23076,71071,16435
"664",2008-02-04,6880,14680,7800,23315
"665",2008-02-05,-5453,4082,9535,17862
"666",2008-02-06,3440,11946,8507,21302
"667",2008-02-07,13623,91644,78021,34925
"668",2008-02-08,-19974,7380,27354,14951
"669",2008-02-11,1876,12803,10927,16827
"670",2008-02-12,-3978,4265,8243,12849
"671",2008-02-13,-5904,7804,13708,6945
"672",2008-02-14,42632,111844,69212,49577
"673",2008-02-15,-52332,75017,127348,-2755
"674",2008-02-19,14396,24082,9686,11641
"675",2008-02-20,-10444,6362,16805,1197
"676",2008-02-21,22595,97101,74506,23792
"677",2008-02-22,-18990,7270,26260,4802
"678",2008-02-25,5545,15034,9489,10347
"679",2008-02-26,-8249,3977,12226,2098
"680",2008-02-27,3976,19109,15133,6074
"681",2008-02-28,10481,95913,85433,16555
"682",2008-02-29,-11370,59670,71040,5185
"683",2008-03-03,14911,58960,44049,20096
"684",2008-03-04,-4793,4560,9352,15303
"685",2008-03-05,1820,12024,10204,17123
"686",2008-03-06,9518,97603,88084,26641
"687",2008-03-07,-12068,7882,19950,14573
"688",2008-03-10,4827,15489,10662,19400
"689",2008-03-11,-4455,4554,9009,14945
"690",2008-03-12,-4821,10336,15157,10124
"691",2008-03-13,4811,90026,85215,14935
"692",2008-03-14,752,18199,17447,15687
"693",2008-03-17,13399,63993,50594,29086
"694",2008-03-18,-3828,4847,8676,25258
"695",2008-03-19,-3283,11636,14919,21975
"696",2008-03-20,1879,83395,81516,23854
"697",2008-03-21,-8102,8906,17008,15752
"698",2008-03-24,2758,12350,9592,18510
"699",2008-03-25,-5313,3939,9252,13197
"700",2008-03-26,-4907,10358,15265,8290
"701",2008-03-27,10714,95424,84710,19004
"702",2008-03-28,-5086,9493,14579,13918
"703",2008-03-31,26379,65431,39052,40297
"704",2008-04-01,2261,46824,44564,42558
"705",2008-04-02,2995,12139,9144,45553
"706",2008-04-03,-36981,72987,109968,8572
"707",2008-04-04,-6192,10518,16710,2380
"708",2008-04-07,2539,14073,11533,4919
"709",2008-04-08,-2019,8004,10023,2900
"710",2008-04-09,-5064,10215,15280,-2164
"711",2008-04-10,1047,85976,84929,-1117
"712",2008-04-11,-806,12435,13242,-1923
"713",2008-04-14,12073,20320,8246,10150
"714",2008-04-15,5379,75052,69673,15529
"715",2008-04-16,-1030,39706,40735,14499
"716",2008-04-17,-7231,94186,101417,7268
"717",2008-04-18,3688,19766,16078,10956
"718",2008-04-21,-847,28331,29178,10109
"719",2008-04-22,18809,49330,30522,28918
"720",2008-04-23,14933,29540,14607,43851
"721",2008-04-24,2890,80102,77213,46741
"722",2008-04-25,6779,22798,16019,53520
"723",2008-04-28,19917,28571,8654,73437
"724",2008-04-29,18876,29232,10357,92313
"725",2008-04-30,42554,83072,40517,134867
"726",2008-05-01,-38135,73254,111389,96732
"727",2008-05-02,-27682,12361,40042,69050
"728",2008-05-05,123,13368,13245,69173
"729",2008-05-06,-5910,6486,12397,63263
"730",2008-05-07,1164,12695,11531,64427
"731",2008-05-08,-5740,71089,76829,58687
"732",2008-05-09,-15872,6909,22781,42815
"733",2008-05-12,3458,11949,8490,46273
"734",2008-05-13,-5748,2946,8694,40525
"735",2008-05-14,-5664,10309,15973,34861
"736",2008-05-15,-33000,156218,189218,1861
"737",2008-05-16,-3011,14628,17639,-1150
"738",2008-05-19,1762,12418,10656,612
"739",2008-05-20,11927,21580,9653,12539
"740",2008-05-21,-4283,11936,16220,8256
"741",2008-05-22,9418,84083,74665,17674
"742",2008-05-23,-928,7477,8405,16746
"743",2008-05-27,4149,12104,7955,20895
"744",2008-05-28,-12052,5849,17901,8843
"745",2008-05-29,4000,84510,80510,12843
"746",2008-05-30,-4783,27821,32604,8060
"747",2008-06-02,20306,78636,58331,28366
"748",2008-06-03,-27030,4247,31277,1336
"749",2008-06-04,435,10837,10402,1771
"750",2008-06-05,943,90126,89183,2714
"751",2008-06-06,-2190,7244,9434,524
"752",2008-06-09,3358,11816,8459,3882
"753",2008-06-10,-3922,5094,9016,-40
"754",2008-06-11,18016,32937,14920,17976
"755",2008-06-12,-19222,76437,95658,-1246
"756",2008-06-13,6152,19010,12857,4906
"757",2008-06-16,30822,85182,54359,35728
"758",2008-06-17,6159,15481,9322,41887
"759",2008-06-18,268,15821,15553,42155
"760",2008-06-19,-30087,73841,103927,12068
"761",2008-06-20,6989,15123,8134,19057
"762",2008-06-23,13254,20694,7440,32311
"763",2008-06-24,-2368,7612,9980,29943
"764",2008-06-25,-5357,11338,16695,24586
"765",2008-06-26,-9123,70393,79515,15463
"766",2008-06-27,-1091,9988,11079,14372
"767",2008-06-30,33100,73277,40177,47472
"768",2008-07-01,-37138,15194,52332,10334
"769",2008-07-02,289,12098,11809,10623
"770",2008-07-03,-2815,93795,96610,7808
"771",2008-07-07,4919,15746,10827,12727
"772",2008-07-08,-6702,3734,10435,6025
"773",2008-07-09,-7273,8835,16108,-1248
"774",2008-07-10,4551,84996,80446,3303
"775",2008-07-11,-3262,7508,10770,41
"776",2008-07-14,-600,13591,14191,-559
"777",2008-07-15,700,20174,19473,141
"778",2008-07-16,438,15677,15239,579
"779",2008-07-17,2326,87242,84916,2905
"780",2008-07-18,1119,8294,7176,4024
"781",2008-07-21,4932,11532,6600,8956
"782",2008-07-22,3866,11799,7932,12822
"783",2008-07-23,-894,13138,14032,11928
"784",2008-07-24,5910,80235,74324,17838
"785",2008-07-25,-2355,7749,10104,15483
"786",2008-07-28,1032,12945,11913,16515
"787",2008-07-29,-7693,5206,12898,8822
"788",2008-07-30,1000,9214,8214,9822
"789",2008-07-31,45889,168586,122697,55711
"790",2008-08-01,-46368,20382,66750,9343
"791",2008-08-04,4907,13736,8829,14250
"792",2008-08-05,-4787,4198,8985,9463
"793",2008-08-06,4103,11424,7321,13566
"794",2008-08-07,-3735,82384,86119,9831
"795",2008-08-08,-3537,7207,10745,6294
"796",2008-08-11,2465,11454,8989,8759
"797",2008-08-12,-4425,3557,7982,4334
"798",2008-08-13,19908,33265,13357,24242
"799",2008-08-14,-10406,88029,98434,13836
"800",2008-08-15,-14578,77313,91890,-742
"801",2008-08-18,10499,18171,7672,9757
"802",2008-08-19,-4259,2923,7182,5498
"803",2008-08-20,-3690,10805,14496,1808
"804",2008-08-21,2549,92317,89768,4357
"805",2008-08-22,-2965,7431,10396,1392
"806",2008-08-25,2822,11866,9044,4214
"807",2008-08-26,4669,14171,9502,8883
"808",2008-08-27,-6466,8217,14683,2417
"809",2008-08-28,18247,110797,92550,20664
"810",2008-08-29,-19638,11298,30937,1026
"811",2008-09-02,29590,82845,53254,30616
"812",2008-09-03,-24810,6187,30997,5806
"813",2008-09-04,-1744,92135,93879,4062
"814",2008-09-05,-4298,7491,11789,-236
"815",2008-09-08,955,11540,10585,719
"816",2008-09-09,15132,24219,9087,15851
"817",2008-09-10,-5001,8973,13974,10850
"818",2008-09-11,-6832,86927,93758,4018
"819",2008-09-12,7778,14802,7024,11796
"820",2008-09-15,3549,80341,76792,15345
"821",2008-09-16,15927,23197,7270,31272
"822",2008-09-17,440,14284,13844,31712
"823",2008-09-18,14680,133245,118565,46392
"824",2008-09-19,66889,78383,11493,113281
"825",2008-09-22,69839,80580,10741,183120
"826",2008-09-23,-1536,10202,11738,181584
"827",2008-09-24,-5938,10934,16872,175646
"828",2008-09-25,51931,151792,99860,227577
"829",2008-09-26,35738,47626,11888,263315
"830",2008-09-29,66313,75379,9066,329628
"831",2008-09-30,36131,71760,35628,365759
"832",2008-10-02,14825,138350,123525,380584
"833",2008-10-03,21667,54062,32395,402251
"834",2008-10-06,-781,11364,12146,401470
"835",2008-10-07,23561,34138,10578,425031
"836",2008-10-08,23164,39112,15949,448195
"837",2008-10-09,10076,128381,118305,458271
"838",2008-10-10,25549,36795,11246,483820
"839",2008-10-14,1906,12512,10606,485726
"840",2008-10-15,22264,62198,39934,507990
"841",2008-10-16,9102,141219,132117,517092
"842",2008-10-17,-10143,7436,17579,506949
"843",2008-10-20,131294,141306,10012,638243
"844",2008-10-21,-3865,6344,10209,634378
"845",2008-10-22,32000,46935,14934,666378
"846",2008-10-23,20982,152153,131171,687360
"847",2008-10-24,-3943,6784,10727,683417
"848",2008-10-27,2345,11367,9022,685762
"849",2008-10-28,-119990,3356,123347,565772
"850",2008-10-29,140,9925,9784,565912
"851",2008-10-30,2399,125900,123501,568311
"852",2008-10-31,18516,78420,59903,586827
"853",2008-11-03,-21267,25307,46573,565560
"854",2008-11-04,-5627,5407,11035,559933
"855",2008-11-05,-42,10780,10822,559891
"856",2008-11-06,50217,168165,117948,610108
"857",2008-11-07,-5497,6620,12117,604611
"858",2008-11-10,-2949,11001,13950,601662
"859",2008-11-12,-14802,5852,20655,586860
"860",2008-11-13,-45043,98534,143577,541817
"861",2008-11-14,-558,50052,50610,541259
"862",2008-11-17,-11830,87324,99154,529429
"863",2008-11-18,27655,38038,10383,557084
"864",2008-11-19,-6080,10280,16360,551004
"865",2008-11-20,-6893,117451,124344,544111
"866",2008-11-21,-7876,6837,14713,536235
"867",2008-11-24,-14454,10738,25192,521781
"868",2008-11-25,-44814,6370,51184,476967
"869",2008-11-26,-6730,12923,19653,470237
"870",2008-11-28,4088,144292,140204,474325
"871",2008-12-01,11241,83472,72231,485566
"872",2008-12-02,4045,6105,2059,489611
"873",2008-12-03,-20711,10257,30967,468900
"874",2008-12-04,-30954,101993,132947,437946
"875",2008-12-05,-6202,6830,13031,431744
"876",2008-12-08,2321,11513,9192,434065
"877",2008-12-09,-4379,4565,8944,429686
"878",2008-12-10,-6339,9135,15473,423347
"879",2008-12-11,-34470,111322,145792,388877
"880",2008-12-12,-1899,12562,14461,386978
"881",2008-12-15,74272,106388,32116,461250
"882",2008-12-16,3382,13199,9817,464632
"883",2008-12-17,-4715,9824,14540,459917
"884",2008-12-18,-68081,111885,179966,391836
"885",2008-12-19,-635,11621,12256,391201
"886",2008-12-22,6080,15974,9894,397281
"887",2008-12-23,-8995,6168,15163,388286
"888",2008-12-24,-6122,14752,20874,382164
"889",2008-12-26,-33240,91368,124607,348924
"890",2008-12-29,-54,14896,14950,348870
"891",2008-12-30,-3559,8341,11900,345311
"892",2008-12-31,-6796,91402,98198,338515
"893",2009-01-02,-82886,143910,226795,255629
"894",2009-01-05,5774,16324,10550,261403
"895",2009-01-06,-4032,6038,10070,257371
"896",2009-01-07,3429,13623,10194,260800
"897",2009-01-08,-31826,119571,151397,228974
"898",2009-01-09,-22269,8641,30910,206705
"899",2009-01-12,3926,14857,10932,210631
"900",2009-01-13,-2546,7741,10287,208085
"901",2009-01-14,-3398,12902,16301,204687
"902",2009-01-15,13773,210239,196465,218460
"903",2009-01-16,-14349,18100,32449,204111
"904",2009-01-20,3999,13389,9391,208110
"905",2009-01-21,12303,36203,23900,220413
"906",2009-01-22,-12158,134020,146178,208255
"907",2009-01-23,570,12504,11935,208825
"908",2009-01-26,2393,14955,12562,211218
"909",2009-01-27,-14008,4782,18790,197210
"910",2009-01-28,-9541,8983,18525,187669
"911",2009-01-29,7734,138439,130704,195403
"912",2009-01-30,-27783,18759,46543,167620
"913",2009-02-02,51950,101798,49848,219570
"914",2009-02-03,-27172,5409,32581,192398
"915",2009-02-04,-475,10461,10936,191923
"916",2009-02-05,40244,128860,88616,232167
"917",2009-02-06,-21407,8197,29604,210760
"918",2009-02-09,560,12186,11625,211320
"919",2009-02-10,-7577,4059,11636,203743
"920",2009-02-11,-9404,8670,18074,194339
"921",2009-02-12,37372,129062,91690,231711
"922",2009-02-13,-32065,10616,42681,199646
"923",2009-02-17,11653,98049,86395,211299
"924",2009-02-18,-16627,5600,22227,194672
"925",2009-02-19,8890,109671,100781,203562
"926",2009-02-20,9141,42590,33449,212703
"927",2009-02-23,4830,16057,11227,217533
"928",2009-02-24,-6614,5387,12001,210919
"929",2009-02-25,-11116,8610,19726,199803
"930",2009-02-26,33529,145837,112308,233332
"931",2009-02-27,-35139,12475,47614,198193
"932",2009-03-02,75005,129790,54785,273198
"933",2009-03-03,-27889,5041,32930,245309
"934",2009-03-04,-2325,10874,13199,242984
"935",2009-03-05,-1330,136757,138087,241654
"936",2009-03-06,-18510,8728,27238,223144
"937",2009-03-09,2941,15250,12308,226085
"938",2009-03-10,-7156,4356,11512,218929
"939",2009-03-11,-9786,8985,18770,209143
"940",2009-03-12,18560,159683,141123,227703
"941",2009-03-13,-9014,14853,23867,218689
"942",2009-03-16,71212,102487,31275,289901
"943",2009-03-17,-5826,5525,11351,284075
"944",2009-03-18,-8280,9484,17765,275795
"945",2009-03-19,-2490,136896,139385,273305
"946",2009-03-20,-15496,8408,23904,257809
"947",2009-03-23,-9160,13037,22197,248649
"948",2009-03-24,-9327,4277,13604,239322
"949",2009-03-25,-8500,9436,17936,230822
"950",2009-03-26,-1738,135468,137206,229084
"951",2009-03-27,-12042,8084,20126,217042
"952",2009-03-30,-4130,13947,18077,212912
"953",2009-03-31,27784,110783,82999,240696
"954",2009-04-01,-29127,22612,51739,211569
"955",2009-04-02,3893,139616,135723,215462
"956",2009-04-03,-2582,38871,41453,212880
"957",2009-04-06,-981,11776,12757,211899
"958",2009-04-07,-7046,5789,12835,204853
"959",2009-04-08,-7359,10206,17565,197494
"960",2009-04-09,17796,157652,139856,215290
"961",2009-04-10,-12047,8633,20680,203243
"962",2009-04-13,1649,13807,12158,204892
"963",2009-04-14,6255,16933,10678,211147
"964",2009-04-15,57104,99855,42750,268251
"965",2009-04-16,-39030,95260,134290,229221
"966",2009-04-17,-2426,19492,21918,226795
"967",2009-04-20,10358,22522,12164,237153
"968",2009-04-21,25144,39038,13894,262297
"969",2009-04-22,5036,23452,18416,267333
"970",2009-04-23,-6531,100049,106581,260802
"971",2009-04-24,-4232,20078,24310,256570
"972",2009-04-27,14263,22830,8567,270833
"973",2009-04-28,1118,13371,12253,271951
"974",2009-04-29,-35332,11605,46937,236619
"975",2009-04-30,73382,204681,131300,310001
"976",2009-05-01,-54302,22801,77103,255699
"977",2009-05-04,407,15805,15398,256106
"978",2009-05-05,-7983,6673,14656,248123
"979",2009-05-06,-3649,11852,15501,244474
"980",2009-05-07,14161,157694,143533,258635
"981",2009-05-08,-4414,7264,11678,254221
"982",2009-05-11,42,10774,10732,254263
"983",2009-05-12,-11764,3673,15437,242499
"984",2009-05-13,-11533,8352,19884,230966
"985",2009-05-14,5363,139143,133780,236329
"986",2009-05-15,-12761,134582,147343,223568
"987",2009-05-18,2842,17789,14947,226410
"988",2009-05-19,-6394,3348,9742,220016
"989",2009-05-20,-8282,10701,18983,211734
"990",2009-05-21,-688,135291,135980,211046
"991",2009-05-22,-9785,7471,17255,201261
"992",2009-05-26,1104,11441,10337,202365
"993",2009-05-27,-17769,5584,23353,184596
"994",2009-05-28,9021,141758,132737,193617
"995",2009-05-29,-4604,11856,16460,189013
"996",2009-06-01,49572,128434,78862,238585
"997",2009-06-02,-4829,6323,11152,233756
"998",2009-06-03,-22318,9962,32280,211438
"999",2009-06-04,292,194196,193904,211730
"1000",2009-06-05,-3885,6646,10531,207845
"1001",2009-06-08,733,11215,10482,208578
"1002",2009-06-09,-6850,3924,10774,201728
"1003",2009-06-10,-10768,9403,20170,190960
"1004",2009-06-11,-7016,130916,137932,183944
"1005",2009-06-12,-2872,14153,17025,181072
"1006",2009-06-15,54516,113296,58780,235588
"1007",2009-06-16,6982,16723,9741,242570
"1008",2009-06-17,64031,80170,16139,306601
"1009",2009-06-18,-10649,98506,109155,295952
"1010",2009-06-19,1920,13915,11995,297872
"1011",2009-06-22,7557,17569,10012,305429
"1012",2009-06-23,-5820,6377,12198,299609
"1013",2009-06-24,-46934,9164,56098,252675
"1014",2009-06-25,-9242,96922,106164,243433
"1015",2009-06-26,-10522,8005,18526,232911
"1016",2009-06-29,3336,16433,13096,236247
"1017",2009-06-30,53485,120464,66979,289732
"1018",2009-07-01,-37766,20669,58436,251966
"1019",2009-07-02,-52902,136443,189345,199064
"1020",2009-07-06,30125,39596,9471,229189
"1021",2009-07-07,-10582,3491,14074,218607
"1022",2009-07-08,-8099,8655,16754,210508
"1023",2009-07-09,-13104,104632,117736,197404
"1024",2009-07-10,-4077,7828,11905,193327
"1025",2009-07-13,-255,11111,11366,193072
"1026",2009-07-14,-2428,8390,10818,190644
"1027",2009-07-15,48060,88619,40558,238704
"1028",2009-07-16,14463,147509,133046,253167
"1029",2009-07-17,-3950,6166,10116,249217
"1030",2009-07-20,-406,10280,10686,248811
"1031",2009-07-21,-6250,3442,9693,242561
"1032",2009-07-22,-7377,10850,18227,235184
"1033",2009-07-23,5142,136856,131714,240326
"1034",2009-07-24,-5528,6794,12322,234798
"1035",2009-07-27,3127,12108,8982,237925
"1036",2009-07-28,-7217,3806,11024,230708
"1037",2009-07-29,721,11306,10586,231429
"1038",2009-07-30,-32232,162295,194527,199197
"1039",2009-07-31,67355,129287,61932,266552
"1040",2009-08-03,-24593,24409,49002,241959
"1041",2009-08-04,-7094,5505,12599,234865
"1042",2009-08-05,284,10978,10694,235149
"1043",2009-08-06,-6341,136061,142402,228808
"1044",2009-08-07,-4062,7522,11584,224746
"1045",2009-08-10,-845,11235,12081,223901
"1046",2009-08-11,-7585,3786,11371,216316
"1047",2009-08-12,-6977,9962,16939,209339
"1048",2009-08-13,-8179,143569,151748,201160
"1049",2009-08-14,-2533,10093,12627,198627
"1050",2009-08-17,-6913,107975,114889,191714
"1051",2009-08-18,29051,39309,10258,220765
"1052",2009-08-19,-6876,10017,16893,213889
"1053",2009-08-20,-4801,129489,134290,209088
"1054",2009-08-21,-6609,7048,13657,202479
"1055",2009-08-24,-1544,12315,13858,200935
"1056",2009-08-25,-5791,3225,9015,195144
"1057",2009-08-26,-8743,9620,18363,186401
"1058",2009-08-27,-1506,128104,129609,184895
"1059",2009-08-28,-2515,8635,11150,182380
"1060",2009-08-31,84507,124796,40289,266887
"1061",2009-09-01,-34043,13646,47689,232844
"1062",2009-09-02,-519,11262,11781,232325
"1063",2009-09-03,-34324,93290,127614,198001
"1064",2009-09-04,-6065,9369,15435,191936
"1065",2009-09-08,-3316,12133,15449,188620
"1066",2009-09-09,-12232,6911,19143,176388
"1067",2009-09-10,6413,122699,116285,182801
"1068",2009-09-11,-3749,9396,13145,179052
"1069",2009-09-14,2957,17953,14996,182009
"1070",2009-09-15,62388,111836,49449,244397
"1071",2009-09-16,1633,19017,17384,246030
"1072",2009-09-17,-22176,82670,104846,223854
"1073",2009-09-18,1581,16387,14806,225435
"1074",2009-09-21,4771,19348,14577,230206
"1075",2009-09-22,2943,13585,10642,233149
"1076",2009-09-23,-8667,12393,21059,224482
"1077",2009-09-24,-53519,111728,165247,170963
"1078",2009-09-25,-6713,6952,13665,164250
"1079",2009-09-28,-702,12974,13676,163548
"1080",2009-09-29,-2547,8089,10636,161001
"1081",2009-09-30,85936,138376,52440,246937
"1082",2009-10-01,-77558,99226,176785,169379
"1083",2009-10-02,-24337,9027,33364,145042
"1084",2009-10-05,-2379,10422,12801,142663
"1085",2009-10-06,-8273,4070,12343,134390
"1086",2009-10-07,237,11275,11037,134627
"1087",2009-10-08,-35175,94265,129439,99452
"1088",2009-10-09,-2989,6551,9540,96463
"1089",2009-10-13,6516,21182,14666,102979
"1090",2009-10-14,-13769,7526,21296,89210
"1091",2009-10-15,38894,184860,145966,128104
"1092",2009-10-16,-3018,13199,16217,125086
"1093",2009-10-19,-2911,11122,14033,122175
"1094",2009-10-20,-5957,5791,11748,116218
"1095",2009-10-21,-3842,13351,17193,112376
"1096",2009-10-22,-61638,121569,183208,50738
"1097",2009-10-23,-1062,8324,9386,49676
"1098",2009-10-26,545,10338,9792,50221
"1099",2009-10-27,-6377,5105,11483,43844
"1100",2009-10-28,-9607,9385,18992,34237
"1101",2009-10-29,-26878,112276,139154,7359
"1102",2009-10-30,1030,42841,41811,8389
"1103",2009-11-02,87488,143973,56484,95877
"1104",2009-11-03,-27229,7357,34585,68648
"1105",2009-11-04,1612,12202,10591,70260
"1106",2009-11-05,996,101585,100589,71256
"1107",2009-11-06,-4093,7128,11221,67163
"1108",2009-11-09,-28,9942,9969,67135
"1109",2009-11-10,-15484,4539,20023,51651
"1110",2009-11-12,977,103821,102844,52628
"1111",2009-11-13,-12220,10326,22547,40408
"1112",2009-11-16,27057,114588,87531,67465
"1113",2009-11-17,-7867,4631,12497,59598
"1114",2009-11-18,-8627,10222,18850,50971
"1115",2009-11-19,-29418,129184,158603,21553
"1116",2009-11-20,-4371,6907,11277,17182
"1117",2009-11-23,521,11598,11078,17703
"1118",2009-11-24,-7742,5307,13049,9961
"1119",2009-11-25,-8298,10584,18882,1663
"1120",2009-11-27,-1821,107788,109608,-158
"1121",2009-11-30,88027,134519,46493,87869
"1122",2009-12-01,-37647,14243,51890,50222
"1123",2009-12-02,-1411,11347,12758,48811
"1124",2009-12-03,-27183,101903,129086,21628
"1125",2009-12-04,-2741,8556,11297,18887
"1126",2009-12-07,-4817,10410,15227,14070
"1127",2009-12-08,-7318,3897,11215,6752
"1128",2009-12-09,37270,55544,18273,44022
"1129",2009-12-10,4894,123906,119012,48916
"1130",2009-12-11,-3798,8988,12786,45118
"1131",2009-12-14,-13554,16732,30286,31564
"1132",2009-12-15,89407,119459,30051,120971
"1133",2009-12-16,-261,18600,18861,120710
"1134",2009-12-17,-42853,127224,170078,77857
"1135",2009-12-18,1281,11941,10660,79138
"1136",2009-12-21,3434,14343,10909,82572
"1137",2009-12-22,-3291,8331,11622,79281
"1138",2009-12-23,28821,57681,28860,108102
"1139",2009-12-24,-7385,102639,110024,100717
"1140",2009-12-28,3129,14837,11709,103846
"1141",2009-12-29,-13927,12570,26497,89919
"1142",2009-12-30,38288,64940,26652,128207
"1143",2009-12-31,37060,223439,186379,165267
"1144",2010-01-04,-14767,29540,44307,150500
"1145",2010-01-05,-8464,6405,14869,142036
"1146",2010-01-06,3173,14323,11150,145209
"1147",2010-01-07,-28466,74360,102826,116743
"1148",2010-01-08,1684,13254,11571,118427
"1149",2010-01-11,-268,12357,12626,118159
"1150",2010-01-12,-6008,7155,13163,112151
"1151",2010-01-13,-9306,10102,19408,102845
"1152",2010-01-14,-30989,98954,129942,71856
"1153",2010-01-15,53052,104400,51348,124908
"1154",2010-01-19,12054,23162,11109,136962
"1155",2010-01-20,12210,32658,20448,149172
"1156",2010-01-21,-30473,74526,104998,118699
"1157",2010-01-22,-4573,8555,13128,114126
"1158",2010-01-25,2630,13749,11118,116756
"1159",2010-01-26,-4333,7092,11425,112423
"1160",2010-01-27,-7042,10734,17777,105381
"1161",2010-01-28,-32162,69722,101883,73219
"1162",2010-01-29,-10036,13134,23170,63183
"1163",2010-02-01,65362,146672,81310,128545
"1164",2010-02-02,-4196,6571,10767,124349
"1165",2010-02-03,-23143,11127,34271,101206
"1166",2010-02-04,-17768,78192,95960,83438
"1167",2010-02-05,-26193,7967,34160,57245
"1168",2010-02-08,614,13844,13231,57859
"1169",2010-02-09,-8278,5343,13621,49581
"1170",2010-02-10,-2829,16953,19783,46752
"1171",2010-02-11,223,111491,111268,46975
"1172",2010-02-12,-32098,11525,43623,14877
"1173",2010-02-16,26093,126047,99954,40970
"1174",2010-02-17,-12673,8720,21393,28297
"1175",2010-02-18,11005,97534,86529,39302
"1176",2010-02-19,-27094,7715,34809,12208
"1177",2010-02-22,-961,13898,14859,11247
"1178",2010-02-23,-9285,5488,14773,1962
"1179",2010-02-24,-10375,9810,20185,-8413
"1180",2010-02-25,28038,121113,93075,19625
"1181",2010-02-26,-6163,19345,25508,13462
"1182",2010-03-01,64899,150694,85795,78361
"1183",2010-03-02,-5886,6734,12620,72475
"1184",2010-03-03,-20517,13809,34326,51958
"1185",2010-03-04,24718,116744,92026,76676
"1186",2010-03-05,-17473,8610,26083,59203
"1187",2010-03-08,2982,17896,14914,62185
"1188",2010-03-09,-6682,6626,13308,55503
"1189",2010-03-10,-8585,11317,19902,46918
"1190",2010-03-11,22422,148275,125852,69340
"1191",2010-03-12,-6893,13346,20238,62447
"1192",2010-03-15,86808,115663,28856,149255
"1193",2010-03-16,4685,15258,10573,153940
"1194",2010-03-17,-7829,11459,19288,146111
"1195",2010-03-18,13214,119606,106391,159325
"1196",2010-03-19,-16731,9334,26065,142594
"1197",2010-03-22,353,14339,13987,142947
"1198",2010-03-23,-8148,3876,12024,134799
"1199",2010-03-24,-11062,9398,20459,123737
"1200",2010-03-25,17671,124495,106824,141408
"1201",2010-03-26,-16664,7271,23935,124744
"1202",2010-03-29,-3631,13847,17478,121113
"1203",2010-03-30,-6483,6172,12655,114630
"1204",2010-03-31,75546,141081,65535,190176
"1205",2010-04-01,-24330,151503,175833,165846
"1206",2010-04-02,-34502,8895,43398,131344
"1207",2010-04-05,20488,34216,13728,151832
"1208",2010-04-06,-8515,5831,14346,143317
"1209",2010-04-07,779,12630,11851,144096
"1210",2010-04-08,24010,153087,129077,168106
"1211",2010-04-09,-10480,8692,19172,157626
"1212",2010-04-12,4486,13999,9513,162112
"1213",2010-04-13,-1297,9998,11295,160815
"1214",2010-04-14,-2726,17055,19781,158089
"1215",2010-04-15,61172,234026,172854,219261
"1216",2010-04-16,-4613,15464,20077,214648
"1217",2010-04-19,-7037,23759,30795,207611
"1218",2010-04-20,23977,36481,12504,231588
"1219",2010-04-21,4123,25199,21076,235711
"1220",2010-04-22,-8247,118740,126987,227464
"1221",2010-04-23,-1760,20207,21967,225704
"1222",2010-04-26,12168,20896,8728,237872
"1223",2010-04-27,4390,15324,10933,242262
"1224",2010-04-28,-11735,10323,22057,230527
"1225",2010-04-29,-24929,99013,123942,205598
"1226",2010-04-30,66307,147468,81161,271905
"1227",2010-05-03,-24539,28927,53466,247366
"1228",2010-05-04,-7490,9032,16522,239876
"1229",2010-05-05,3697,16505,12808,243573
"1230",2010-05-06,-22065,134646,156711,221508
"1231",2010-05-07,-8814,7986,16800,212694
"1232",2010-05-10,-6513,12397,18909,206181
"1233",2010-05-11,-6481,5167,11648,199700
"1234",2010-05-12,-9793,11067,20860,189907
"1235",2010-05-13,-4124,117039,121163,185783
"1236",2010-05-14,-4980,13577,18558,180803
"1237",2010-05-17,38407,112309,73902,219210
"1238",2010-05-18,-7427,4196,11623,211783
"1239",2010-05-19,-7951,11178,19129,203832
"1240",2010-05-20,2527,119263,116736,206359
"1241",2010-05-21,-6383,7183,13566,199976
"1242",2010-05-24,2806,12600,9795,202782
"1243",2010-05-25,-4360,4633,8993,198422
"1244",2010-05-26,-8055,11965,20019,190367
"1245",2010-05-27,6979,118706,111727,197346
"1246",2010-05-28,-3811,11838,15648,193535
"1247",2010-06-01,46251,139440,93189,239786
"1248",2010-06-02,-3826,9003,12829,235960
"1249",2010-06-03,-21818,150336,172154,214142
"1250",2010-06-04,-4935,7352,12286,209207
"1251",2010-06-07,-683,11012,11695,208524
"1252",2010-06-08,-6878,5028,11907,201646
"1253",2010-06-09,-8886,10545,19430,192760
"1254",2010-06-10,-11557,145495,157052,181203
"1255",2010-06-11,-3294,9827,13122,177909
"1256",2010-06-14,8392,20496,12104,186301
"1257",2010-06-15,72583,130779,58196,258884
"1258",2010-06-16,648,19211,18563,259532
"1259",2010-06-17,-45200,122281,167481,214332
"1260",2010-06-18,2460,12840,10380,216792
"1261",2010-06-21,8005,18886,10881,224797
"1262",2010-06-22,2343,13226,10882,227140
"1263",2010-06-23,-7177,11589,18766,219963
"1264",2010-06-24,-10044,117849,127893,209919
"1265",2010-06-25,-4088,8442,12530,205831
"1266",2010-06-28,-364,12959,13322,205467
"1267",2010-06-29,-3751,7382,11133,201716
"1268",2010-06-30,59503,129875,70372,261219
"1269",2010-07-01,-40257,164764,205021,220962
"1270",2010-07-02,-23483,9476,32960,197479
"1271",2010-07-06,-1295,11288,12583,196184
"1272",2010-07-07,-6069,7301,13370,190115
"1273",2010-07-08,10006,135115,125109,200121
"1274",2010-07-09,-6279,6895,13173,193842
"1275",2010-07-12,-378,12193,12571,193464
"1276",2010-07-13,-6795,3820,10615,186669
"1277",2010-07-14,-5073,12961,18034,181596
"1278",2010-07-15,42104,218074,175970,223700
"1279",2010-07-16,3135,13078,9944,226835
"1280",2010-07-19,1889,10634,8745,228724
"1281",2010-07-20,-4455,4915,9370,224269
"1282",2010-07-21,-6769,11560,18329,217500
"1283",2010-07-22,3312,123638,120325,220812
"1284",2010-07-23,-4360,9458,13818,216452
"1285",2010-07-26,2680,12310,9630,219132
"1286",2010-07-27,-6007,4394,10402,213125
"1287",2010-07-28,-9093,10290,19383,204032
"1288",2010-07-29,-1464,153927,155391,202568
"1289",2010-07-30,-27683,10057,37740,174885
"1290",2010-08-02,66846,134271,67424,241731
"1291",2010-08-03,-27239,6343,33582,214492
"1292",2010-08-04,3164,14010,10847,217656
"1293",2010-08-05,-808,124983,125791,216848
"1294",2010-08-06,-6088,7760,13847,210760
"1295",2010-08-09,437,12275,11838,211197
"1296",2010-08-10,-4031,7141,11171,207166
"1297",2010-08-11,-6613,11605,18218,200553
"1298",2010-08-12,-480,127290,127771,200073
"1299",2010-08-13,-6128,9669,15797,193945
"1300",2010-08-16,23035,99690,76655,216980
"1301",2010-08-17,-6187,4610,10797,210793
"1302",2010-08-18,-6968,11882,18850,203825
"1303",2010-08-19,-1976,125381,127357,201849
"1304",2010-08-20,-7829,7862,15690,194020
"1305",2010-08-23,1934,14512,12577,195954
"1306",2010-08-24,-8238,3716,11953,187716
"1307",2010-08-25,-8200,9720,17920,179516
"1308",2010-08-26,7250,189077,181828,186766
"1309",2010-08-27,-6515,8262,14777,180251
"1310",2010-08-30,805,11684,10880,181056
"1311",2010-08-31,68083,120333,52250,249139
"1312",2010-09-01,-29816,20468,50284,219323
"1313",2010-09-02,4258,129918,125659,223581
"1314",2010-09-03,-28232,9422,37654,195349
"1315",2010-09-07,-2031,12423,14454,193318
"1316",2010-09-08,-15671,7788,23459,177647
"1317",2010-09-09,3329,133787,130459,180976
"1318",2010-09-10,-2068,8954,11023,178908
"1319",2010-09-13,1790,13457,11667,180698
"1320",2010-09-14,4234,15283,11049,184932
"1321",2010-09-15,103205,138946,35740,288137
"1322",2010-09-16,-35828,128942,164770,252309
"1323",2010-09-17,-4084,10219,14303,248225
"1324",2010-09-20,3120,18257,15136,251345
"1325",2010-09-21,5989,18094,12105,257334
"1326",2010-09-22,-6184,13545,19729,251150
"1327",2010-09-23,-15896,147431,163328,235254
"1328",2010-09-24,-5684,7311,12995,229570
"1329",2010-09-27,5470,13706,8236,235040
"1330",2010-09-28,-7036,5671,12707,228004
"1331",2010-09-29,3454,14194,10739,231458
"1332",2010-09-30,50046,229225,179179,281504
"1333",2010-10-01,-58551,18778,77329,222953
"1334",2010-10-04,4429,14777,10349,227382
"1335",2010-10-05,-6151,6681,12832,221231
"1336",2010-10-06,1927,12297,10369,223158
"1337",2010-10-07,-23740,118328,142069,199418
"1338",2010-10-08,-2987,7084,10071,196431
"1339",2010-10-12,3928,18684,14756,200359
"1340",2010-10-13,-11085,11298,22384,189274
"1341",2010-10-14,-8248,119862,128111,181026
"1342",2010-10-15,49215,83305,34089,230241
"1343",2010-10-18,6483,19373,12889,236724
"1344",2010-10-19,-6557,5354,11911,230167
"1345",2010-10-20,-4306,14449,18755,225861
"1346",2010-10-21,-9535,140331,149866,216326
"1347",2010-10-22,-4498,7208,11706,211828
"1348",2010-10-25,5690,13041,7351,217518
"1349",2010-10-26,-6933,4656,11589,210585
"1350",2010-10-27,-9716,10442,20158,200869
"1351",2010-10-28,-8886,112660,121546,191983
"1352",2010-10-29,5864,23946,18081,197847
"1353",2010-11-01,34226,126049,91823,232073
"1354",2010-11-02,-4027,7526,11552,228046
"1355",2010-11-03,-18378,14047,32426,209668
"1356",2010-11-04,-6334,117701,124035,203334
"1357",2010-11-05,-5358,6773,12131,197976
"1358",2010-11-08,-659,11419,12078,197317
"1359",2010-11-09,-7439,3747,11186,189878
"1360",2010-11-10,-7985,12789,20773,181893
"1361",2010-11-12,-6847,120184,127031,175046
"1362",2010-11-15,46698,104239,57541,221744
"1363",2010-11-16,-928,11138,12066,220816
"1364",2010-11-17,-8481,10727,19208,212335
"1365",2010-11-18,-10634,139962,150596,201701
"1366",2010-11-19,1226,12014,10787,202927
"1367",2010-11-22,1106,11988,10882,204033
"1368",2010-11-23,4772,18038,13266,208805
"1369",2010-11-24,-11144,10274,21418,197661
"1370",2010-11-26,410,120168,119758,198071
"1371",2010-11-29,879,12714,11836,198950
"1372",2010-11-30,54097,111497,57400,253047
"1373",2010-12-01,-33928,20573,54501,219119
"1374",2010-12-02,-2866,122167,125033,216253
"1375",2010-12-03,-23779,8676,32455,192474
"1376",2010-12-06,37,11163,11126,192511
"1377",2010-12-07,-8197,4477,12674,184314
"1378",2010-12-08,8894,27834,18940,193208
"1379",2010-12-09,-6149,113606,119755,187059
"1380",2010-12-10,6798,19226,12428,193857
"1381",2010-12-13,2903,14759,11856,196760
"1382",2010-12-14,-1631,10333,11964,195129
"1383",2010-12-15,70080,122543,52463,265209
"1384",2010-12-16,-1332,149815,151147,263877
"1385",2010-12-17,675,10684,10009,264552
"1386",2010-12-20,3718,14785,11067,268270
"1387",2010-12-21,-1990,10250,12239,266280
"1388",2010-12-22,-2739,17908,20646,263541
"1389",2010-12-23,-4992,119508,124501,258549
"1390",2010-12-27,6572,13280,6708,265121
"1391",2010-12-28,-7551,5199,12750,257570
"1392",2010-12-29,3323,14806,11483,260893
"1393",2010-12-30,-16958,123520,140479,243935
"1394",2011-01-03,-33570,30087,63657,210365
"1395",2011-01-04,-6783,6185,12969,203582
"1396",2011-01-05,5317,17620,12303,208899
"1397",2011-01-06,-9234,113669,122903,199665
"1398",2011-01-07,-5023,8276,13299,194642
"1399",2011-01-10,-117,12994,13111,194525
"1400",2011-01-11,-5514,6147,11661,189011
"1401",2011-01-12,-10275,9217,19491,178736
"1402",2011-01-13,-13498,139598,153096,165238
"1403",2011-01-14,-20868,14012,34880,144370
"1404",2011-01-18,50459,94921,44462,194829
"1405",2011-01-19,2451,22804,20353,197280
"1406",2011-01-20,-699,123290,123990,196581
"1407",2011-01-21,-5326,9669,14995,191255
"1408",2011-01-24,6189,18482,12293,197444
"1409",2011-01-25,1493,10856,9362,198937
"1410",2011-01-26,-1567,17662,19230,197370
"1411",2011-01-27,-12758,118508,131266,184612
"1412",2011-01-28,-7753,12040,19793,176859
"1413",2011-01-31,73487,131625,58137,250346
"1414",2011-02-01,-33604,19401,53005,216742
"1415",2011-02-02,4332,15618,11285,221074
"1416",2011-02-03,-40561,103428,143989,180513
"1417",2011-02-04,-19470,9929,29399,161043
"1418",2011-02-07,-1326,13322,14648,159717
"1419",2011-02-08,-7984,4182,12166,151733
"1420",2011-02-09,-11043,9661,20704,140690
"1421",2011-02-10,-24277,129235,153512,116413
"1422",2011-02-11,-26809,6092,32900,89604
"1423",2011-02-14,4802,17481,12679,94406
"1424",2011-02-15,15412,83108,67696,109818
"1425",2011-02-16,-2048,17654,19702,107770
"1426",2011-02-17,-19827,104947,124774,87943
"1427",2011-02-18,-19324,9917,29241,68619
"1428",2011-02-22,-1059,16403,17463,67560
"1429",2011-02-23,-16203,8018,24221,51357
"1430",2011-02-24,-16092,116248,132340,35265
"1431",2011-02-25,2672,33610,30937,37937
"1432",2011-02-28,53881,133114,79232,91818
"1433",2011-03-01,-33636,20128,53765,58182
"1434",2011-03-02,-5460,13003,18463,52722
"1435",2011-03-03,-22155,134198,156353,30567
"1436",2011-03-04,-20416,10684,31100,10151
"1437",2011-03-07,5073,20213,15141,15224
"1438",2011-03-08,66,11877,11811,15290
"1439",2011-03-09,-8410,11098,19508,6880
"1440",2011-03-10,-26702,135896,162597,-19822
"1441",2011-03-11,-12799,9044,21843,-32621
"1442",2011-03-14,10087,21767,11680,-22534
"1443",2011-03-15,75207,91706,16499,52673
"1444",2011-03-16,1964,23320,21356,54637
"1445",2011-03-17,-23223,110304,133528,31414
"1446",2011-03-18,-14154,9845,23999,17260
"1447",2011-03-21,-623,12862,13486,16637
"1448",2011-03-22,-7921,5053,12974,8716
"1449",2011-03-23,-8765,11436,20200,-49
"1450",2011-03-24,-24376,117218,141594,-24425
"1451",2011-03-25,-9922,6877,16798,-34347
"1452",2011-03-28,1688,12968,11279,-32659
"1453",2011-03-29,-7498,5792,13290,-40157
"1454",2011-03-30,7595,19173,11578,-32562
"1455",2011-03-31,51823,231607,179784,19261
"1456",2011-04-01,-62766,20855,83620,-43505
"1457",2011-04-04,-154,15128,15282,-43659
"1458",2011-04-05,-9645,5337,14982,-53304
"1459",2011-04-06,2483,13335,10852,-50821
"1460",2011-04-07,-6022,136312,142334,-56843
"1461",2011-04-08,-11523,8441,19964,-68366
"1462",2011-04-11,600,13855,13255,-67766
"1463",2011-04-12,-80,10109,10189,-67846
"1464",2011-04-13,855,20101,19246,-66991
"1465",2011-04-14,4766,118233,113466,-62225
"1466",2011-04-15,28651,103032,74382,-33574
"1467",2011-04-18,30532,42447,11915,-3042
"1468",2011-04-19,17743,29049,11306,14701
"1469",2011-04-20,6710,25951,19240,21411
"1470",2011-04-21,-23129,116588,139717,-1718
"1471",2011-04-22,1168,20394,19226,-550
"1472",2011-04-25,16169,25947,9777,15619
"1473",2011-04-26,24310,34920,10609,39929
"1474",2011-04-27,-5530,17449,22979,34399
"1475",2011-04-28,-10707,100821,111528,23692
"1476",2011-04-29,-16028,32363,48391,7664
"1477",2011-05-02,45313,138880,93568,52977
"1478",2011-05-03,-23788,10435,34224,29189
"1479",2011-05-04,4445,16237,11792,33634
"1480",2011-05-05,-21246,121037,142283,12388
"1481",2011-05-06,-2319,13435,15753,10069
"1482",2011-05-09,1520,13185,11665,11589
"1483",2011-05-10,-7008,4060,11068,4581
"1484",2011-05-11,-8465,11318,19783,-3884
"1485",2011-05-12,-13196,100108,113304,-17080
"1486",2011-05-13,-5639,11577,17216,-22719
"1487",2011-05-16,58043,97466,39423,35324
"1488",2011-05-17,-6079,4373,10452,29245
"1489",2011-05-18,-11385,10735,22120,17860
"1490",2011-05-19,-19968,95524,115492,-2108
"1491",2011-05-20,-4398,6925,11324,-6506
"1492",2011-05-23,3232,13258,10027,-3274
"1493",2011-05-24,-6480,9179,15659,-9754
"1494",2011-05-25,-8335,11253,19588,-18089
"1495",2011-05-26,-19543,86132,105675,-37632
"1496",2011-05-27,1140,15901,14762,-36492
"1497",2011-05-31,57318,135555,78238,20826
"1498",2011-06-01,-38640,16859,55499,-17814
"1499",2011-06-02,-10845,118944,129789,-28659
"1500",2011-06-03,-25553,8338,33891,-54212
"1501",2011-06-06,-246,11271,11517,-54458
"1502",2011-06-07,-6635,4656,11291,-61093
"1503",2011-06-08,-7186,11438,18624,-68279
"1504",2011-06-09,237,102174,101937,-68042
"1505",2011-06-10,-3675,8742,12417,-71717
"1506",2011-06-13,17005,28092,11087,-54712
"1507",2011-06-14,4882,15412,10531,-49830
"1508",2011-06-15,84831,125224,40393,35001
"1509",2011-06-16,-7711,97899,105610,27290
"1510",2011-06-17,-1351,9638,10988,25939
"1511",2011-06-20,7208,17293,10085,33147
"1512",2011-06-21,9628,19785,10157,42775
"1513",2011-06-22,-4847,14112,18959,37928
"1514",2011-06-23,-16500,86124,102624,21428
"1515",2011-06-24,-5638,8232,13871,15790
"1516",2011-06-27,3312,14378,11066,19102
"1517",2011-06-28,-7336,3637,10973,11766
"1518",2011-06-29,2034,12521,10487,13800
"1519",2011-06-30,24391,230943,206552,38191
"1520",2011-07-01,-63177,20161,83338,-24986
"1521",2011-07-05,4470,15722,11253,-20516
"1522",2011-07-06,-3988,7399,11386,-24504
"1523",2011-07-07,-10045,92523,102568,-34549
"1524",2011-07-08,-5217,7541,12758,-39766
"1525",2011-07-11,730,11937,11207,-39036
"1526",2011-07-12,-5951,4349,10300,-44987
"1527",2011-07-13,-7357,10148,17505,-52344
"1528",2011-07-14,-3611,107144,110756,-55955
"1529",2011-07-15,61879,82246,20368,5924
"1530",2011-07-18,9609,18012,8403,15533
"1531",2011-07-19,-5451,3634,9085,10082
"1532",2011-07-20,-5415,12222,17637,4667
"1533",2011-07-21,-12926,86545,99471,-8259
"1534",2011-07-22,-6097,6975,13071,-14356
"1535",2011-07-25,4090,15315,11224,-10266
"1536",2011-07-26,-6534,4453,10987,-16800
"1537",2011-07-27,-8225,10581,18805,-25025
"1538",2011-07-28,-20193,112245,132438,-45218
"1539",2011-07-29,13600,25907,12307,-31618
"1540",2011-08-01,1763,127249,125486,-29855
"1541",2011-08-02,-14907,11153,26060,-44762
"1542",2011-08-03,-19713,12401,32114,-64475
"1543",2011-08-04,-19534,82205,101739,-84009
"1544",2011-08-05,15280,27965,12685,-68729
"1545",2011-08-08,1408,13136,11728,-67321
"1546",2011-08-09,-6576,3581,10157,-73897
"1547",2011-08-10,-8283,10051,18334,-82180
"1548",2011-08-11,9564,113379,103816,-72616
"1549",2011-08-12,-1585,8336,9921,-74201
"1550",2011-08-15,-1845,92175,94020,-76046
"1551",2011-08-16,-1225,10127,11352,-77271
"1552",2011-08-17,-10596,8537,19133,-87867
"1553",2011-08-18,1108,99429,98320,-86759
"1554",2011-08-19,15177,29533,14356,-71582
"1555",2011-08-22,2747,14885,12138,-68835
"1556",2011-08-23,-6994,4107,11101,-75829
"1557",2011-08-24,-10061,9444,19505,-85890
"1558",2011-08-25,8730,127492,118763,-77160
"1559",2011-08-26,-3601,7315,10917,-80761
"1560",2011-08-29,3677,13283,9606,-77084
"1561",2011-08-30,-7412,3876,11288,-84496
"1562",2011-08-31,30190,128028,97838,-54306
"1563",2011-09-01,-1362,134925,136288,-55668
"1564",2011-09-02,-24891,10416,35307,-80559
"1565",2011-09-06,-3564,12332,15896,-84123
"1566",2011-09-07,10182,23036,12854,-73941
"1567",2011-09-08,-8144,103040,111184,-82085
"1568",2011-09-09,-4115,6562,10677,-86200
"1569",2011-09-12,3535,14072,10537,-82665
"1570",2011-09-13,5488,16849,11361,-77177
"1571",2011-09-14,-3425,19120,22546,-80602
"1572",2011-09-15,40639,197107,156467,-39963
"1573",2011-09-16,3032,16873,13841,-36931
"1574",2011-09-19,4433,17311,12878,-32498
"1575",2011-09-20,15257,26772,11515,-17241
"1576",2011-09-21,-5309,14600,19909,-22550
"1577",2011-09-22,-14659,122777,137436,-37209
"1578",2011-09-23,-2659,9635,12294,-39868
"1579",2011-09-26,2456,12938,10482,-37412
"1580",2011-09-27,-4089,7112,11201,-41501
"1581",2011-09-28,-10354,11615,21969,-51855
"1582",2011-09-29,-2826,99041,101867,-54681
"1583",2011-09-30,13976,132427,118451,-40705
"1584",2011-10-03,-21935,25116,47051,-62640
"1585",2011-10-04,-5359,5474,10834,-67999
"1586",2011-10-05,2856,13469,10612,-65143
"1587",2011-10-06,-6556,97252,103808,-71699
"1588",2011-10-07,-3039,7862,10901,-74738
"1589",2011-10-11,410,13564,13154,-74328
"1590",2011-10-12,-4795,16743,21538,-79123
"1591",2011-10-13,6821,107184,100364,-72302
"1592",2011-10-14,-8314,10567,18881,-80616
"1593",2011-10-17,68396,94758,26362,-12220
"1594",2011-10-18,-6956,5423,12378,-19176
"1595",2011-10-19,-9303,12469,21772,-28479
"1596",2011-10-20,444,126538,126094,-28035
"1597",2011-10-21,-3604,8052,11656,-31639
"1598",2011-10-24,2570,12808,10239,-29069
"1599",2011-10-25,-4287,7331,11618,-33356
"1600",2011-10-26,-8239,11887,20126,-41595
"1601",2011-10-27,-5177,94774,99951,-46772
"1602",2011-10-28,-5964,10525,16488,-52736
"1603",2011-10-31,53184,132441,79257,448
"1604",2011-11-01,-36244,16726,52970,-35796
"1605",2011-11-02,2887,13440,10552,-32909
"1606",2011-11-03,-22507,102501,125007,-55416
"1607",2011-11-04,-1639,9594,11232,-57055
"1608",2011-11-07,984,12518,11534,-56071
"1609",2011-11-08,-6997,4196,11193,-63068
"1610",2011-11-09,-9513,9621,19133,-72581
"1611",2011-11-10,-3916,100097,104013,-76497
"1612",2011-11-14,12921,31009,18088,-63576
"1613",2011-11-15,16021,90228,74207,-47555
"1614",2011-11-16,-4450,15121,19571,-52005
"1615",2011-11-17,3426,127030,123604,-48579
"1616",2011-11-18,-2273,8620,10893,-50852
"1617",2011-11-21,1451,12329,10878,-49401
"1618",2011-11-22,-4926,5622,10548,-54327
"1619",2011-11-23,-7848,13278,21126,-62175
"1620",2011-11-25,3794,105280,101486,-58381
"1621",2011-11-28,-660,10985,11646,-59041
"1622",2011-11-29,-4554,7455,12008,-63595
"1623",2011-11-30,52401,131667,79265,-11194
"1624",2011-12-01,-36816,112562,149379,-48010
"1625",2011-12-02,-21936,9049,30985,-69946
"1626",2011-12-05,123,11763,11639,-69823
"1627",2011-12-06,-7135,4602,11736,-76958
"1628",2011-12-07,1930,12322,10392,-75028
"1629",2011-12-08,-3062,98137,101199,-78090
"1630",2011-12-09,-3387,8380,11767,-81477
"1631",2011-12-12,16986,28024,11039,-64491
"1632",2011-12-13,-4440,5848,10288,-68931
"1633",2011-12-14,-2154,17657,19811,-71085
"1634",2011-12-15,81126,242974,161847,10041
"1635",2011-12-16,6836,16525,9689,16877
"1636",2011-12-19,4980,15558,10578,21857
"1637",2011-12-20,-4657,5779,10436,17200
"1638",2011-12-21,-7357,14340,21697,9843
"1639",2011-12-22,-4787,98967,103753,5056
"1640",2011-12-23,-2961,11587,14549,2095
"1641",2011-12-27,2897,15959,13062,4992
"1642",2011-12-28,-10336,11791,22128,-5344
"1643",2011-12-29,-464,106047,106511,-5808
"1644",2011-12-30,-7256,32358,39613,-13064
"1645",2012-01-03,2715,136068,133353,-10349
"1646",2012-01-04,-1421,10912,12333,-11770
"1647",2012-01-05,-1502,101078,102580,-13272
"1648",2012-01-06,-5247,8365,13611,-18519
"1649",2012-01-09,610,13508,12897,-17909
"1650",2012-01-10,-6381,5920,12301,-24290
"1651",2012-01-11,-8444,11885,20329,-32734
"1652",2012-01-12,-673,128698,129370,-33407
"1653",2012-01-13,-130,13103,13233,-33537
"1654",2012-01-17,46563,104684,58121,13026
"1655",2012-01-18,-3624,19816,23440,9402
"1656",2012-01-19,4440,103097,98658,13842
"1657",2012-01-20,-5966,10722,16688,7876
"1658",2012-01-23,8690,20557,11867,16566
"1659",2012-01-24,3314,13488,10174,19880
"1660",2012-01-25,-6742,15931,22674,13138
"1661",2012-01-26,-2920,98606,101526,10218
"1662",2012-01-27,-485,9603,10088,9733
"1663",2012-01-30,444,13679,13235,10177
"1664",2012-01-31,49618,127698,78079,59795
"1665",2012-02-01,-37904,24116,62020,21891
"1666",2012-02-02,8384,103875,95490,30275
"1667",2012-02-03,-35177,10550,45727,-4902
"1668",2012-02-06,-10571,13278,23849,-15473
"1669",2012-02-07,-10830,5298,16128,-26303
"1670",2012-02-08,-23361,10833,34194,-49664
"1671",2012-02-09,12533,137609,125076,-37131
"1672",2012-02-10,-4587,7203,11790,-41718
"1673",2012-02-13,8360,24479,16119,-33358
"1674",2012-02-14,-7524,6790,14314,-40882
"1675",2012-02-15,-7853,116135,123987,-48735
"1676",2012-02-16,20234,121242,101009,-28501
"1677",2012-02-17,-12952,8753,21705,-41453
"1678",2012-02-21,-2506,17806,20312,-43959
"1679",2012-02-22,-18807,8219,27026,-62766
"1680",2012-02-23,7822,123760,115938,-54944
"1681",2012-02-24,-7512,7552,15064,-62456
"1682",2012-02-27,-1044,16372,17416,-63500
"1683",2012-02-28,-9705,5053,14758,-73205
"1684",2012-02-29,36948,126325,89377,-36257
"1685",2012-03-01,-716,147421,148137,-36973
"1686",2012-03-02,-26315,10877,37192,-63288
"1687",2012-03-05,468,15990,15522,-62820
"1688",2012-03-06,-8012,5849,13862,-70832
"1689",2012-03-07,-1530,14924,16454,-72362
"1690",2012-03-08,13442,148860,135418,-58920
"1691",2012-03-09,-4126,8045,12171,-63046
"1692",2012-03-12,14618,27300,12682,-48428
"1693",2012-03-13,-593,11715,12309,-49021
"1694",2012-03-14,-4358,21818,26176,-53379
"1695",2012-03-15,55663,208246,152583,2284
"1696",2012-03-16,6501,21885,15385,8785
"1697",2012-03-19,20,13812,13792,8805
"1698",2012-03-20,-8798,5041,13840,7
"1699",2012-03-21,-11633,13555,25188,-11626
"1700",2012-03-22,3787,118396,114609,-7839
"1701",2012-03-23,-4775,7769,12544,-12614
"1702",2012-03-26,1864,13151,11286,-10750
"1703",2012-03-27,-5762,5309,11071,-16512
"1704",2012-03-28,-13834,11851,25685,-30346
"1705",2012-03-29,-4422,106246,110668,-34768
"1706",2012-03-30,-20550,29832,50382,-55318
"1707",2012-04-02,36131,129958,93827,-19187
"1708",2012-04-03,-26175,9260,35436,-45362
"1709",2012-04-04,3338,17980,14641,-42024
"1710",2012-04-05,-8502,128873,137375,-50526
"1711",2012-04-06,-2100,8898,10998,-52626
"1712",2012-04-09,2602,12900,10297,-50024
"1713",2012-04-10,-2839,8603,11442,-52863
"1714",2012-04-11,-10411,13985,24396,-63274
"1715",2012-04-12,-11959,102808,114767,-75233
"1716",2012-04-13,2486,20354,17867,-72747
"1717",2012-04-16,39078,110554,71476,-33669
"1718",2012-04-17,38914,50605,11691,5245
"1719",2012-04-18,-951,24049,25000,4294
"1720",2012-04-19,-43540,111123,154664,-39246
"1721",2012-04-20,6245,17577,11332,-33001
"1722",2012-04-23,15791,28135,12344,-17210
"1723",2012-04-24,26776,39879,13103,9566
"1724",2012-04-25,-5772,21748,27519,3794
"1725",2012-04-26,-2079,103985,106064,1715
"1726",2012-04-27,2621,16387,13766,4336
"1727",2012-04-30,63486,144756,81271,67822
"1728",2012-05-01,-34665,25266,59930,33157
"1729",2012-05-02,4791,19734,14943,37948
"1730",2012-05-03,-23633,129584,153217,14315
"1731",2012-05-04,2070,12573,10502,16385
"1732",2012-05-07,2722,14340,11617,19107
"1733",2012-05-08,-4658,6413,11071,14449
"1734",2012-05-09,-10445,11440,21885,4004
"1735",2012-05-10,-599,102806,103406,3405
"1736",2012-05-11,-5453,8016,13469,-2048
"1737",2012-05-14,4310,15620,11310,2262
"1738",2012-05-15,3524,90017,86493,5786
"1739",2012-05-16,-3550,17337,20887,2236
"1740",2012-05-17,-8847,98093,106940,-6611
"1741",2012-05-18,-1328,8724,10052,-7939
"1742",2012-05-21,3479,12608,9129,-4460
"1743",2012-05-22,-3227,6715,9942,-7687
"1744",2012-05-23,-10746,10688,21434,-18433
"1745",2012-05-24,-8468,94894,103362,-26901
"1746",2012-05-25,-5692,8604,14297,-32593
"1747",2012-05-29,4107,16516,12410,-28486
"1748",2012-05-30,-2717,9311,12029,-31203
"1749",2012-05-31,44774,242541,197767,13571
"1750",2012-06-01,-61261,18680,79941,-47690
"1751",2012-06-04,4751,14338,9588,-42939
"1752",2012-06-05,-6109,5098,11207,-49048
"1753",2012-06-07,-8312,96591,104903,-57360
"1754",2012-06-08,-3798,8881,12680,-61158
"1755",2012-06-11,2084,13522,11437,-59074
"1756",2012-06-12,-2605,6571,9177,-61679
"1757",2012-06-13,-5162,15075,20237,-66841
"1758",2012-06-14,2544,110526,107982,-64297
"1759",2012-06-15,79351,132787,53436,15054
"1760",2012-06-18,12199,22521,10322,27253
"1761",2012-06-19,9433,19953,10520,36686
"1762",2012-06-20,104,21179,21075,36790
"1763",2012-06-21,-6004,98789,104793,30786
"1764",2012-06-22,-3583,10329,13912,27203
"1765",2012-06-25,3517,13592,10075,30720
"1766",2012-06-26,-6255,4739,10993,24465
"1767",2012-06-27,-9633,11396,21028,14832
"1768",2012-06-28,-5813,125644,131457,9019
"1769",2012-06-29,-20691,25925,46616,-11672
"1770",2012-07-02,32996,127565,94569,21324
"1771",2012-07-03,-26907,6536,33443,-5583
"1772",2012-07-05,-3815,100282,104097,-9398
"1773",2012-07-06,-5726,7565,13291,-15124
"1774",2012-07-09,-455,13411,13866,-15579
"1775",2012-07-10,-3106,6149,9255,-18685
"1776",2012-07-11,-9120,12008,21129,-27805
"1777",2012-07-12,-12652,92129,104781,-40457
"1778",2012-07-13,-2493,10367,12860,-42950
"1779",2012-07-16,12222,95051,82829,-30728
"1780",2012-07-17,-5310,4558,9868,-36038
"1781",2012-07-18,-8384,10680,19064,-44422
"1782",2012-07-19,-7850,91983,99833,-52272
"1783",2012-07-20,-4633,7749,12382,-56905
"1784",2012-07-23,2271,13580,11309,-54634
"1785",2012-07-24,-5800,5370,11170,-60434
"1786",2012-07-25,-4400,15372,19771,-64834
"1787",2012-07-26,-7490,117807,125297,-72324
"1788",2012-07-27,-1461,9881,11342,-73785
"1789",2012-07-30,3547,12971,9424,-70238
"1790",2012-07-31,57630,128336,70706,-12608
"1791",2012-08-01,-37802,23895,61696,-50410
"1792",2012-08-02,6310,104318,98008,-44100
"1793",2012-08-03,-25033,10855,35888,-69133
"1794",2012-08-06,1228,12848,11620,-67905
"1795",2012-08-07,-8006,4588,12593,-75911
"1796",2012-08-08,-1070,19270,20340,-76981
"1797",2012-08-09,4680,106022,101342,-72301
"1798",2012-08-10,-1623,7462,9085,-73924
"1799",2012-08-13,2443,12290,9847,-71481
"1800",2012-08-14,-2644,7364,10009,-74125
"1801",2012-08-15,-9062,112877,121939,-83187
"1802",2012-08-16,11102,112242,101140,-72085
"1803",2012-08-17,-6000,7289,13289,-78085
"1804",2012-08-20,2127,14174,12048,-75958
"1805",2012-08-21,-5714,4997,10711,-81672
"1806",2012-08-22,-7740,13868,21607,-89412
"1807",2012-08-23,14160,141548,127389,-75252
"1808",2012-08-24,-3463,6805,10268,-78715
"1809",2012-08-27,3801,13656,9855,-74914
"1810",2012-08-28,-5990,4998,10988,-80904
"1811",2012-08-29,2833,13191,10358,-78071
"1812",2012-08-30,8913,140538,131625,-69158
"1813",2012-08-31,-3814,124743,128556,-72972
"1814",2012-09-04,-764,25538,26302,-73736
"1815",2012-09-05,-2795,9384,12179,-76531
"1816",2012-09-06,24170,147013,122843,-52361
"1817",2012-09-07,-3230,7075,10305,-55591
"1818",2012-09-10,3589,13294,9705,-52002
"1819",2012-09-11,-4767,6179,10946,-56769
"1820",2012-09-12,-7841,13938,21778,-64610
"1821",2012-09-13,-4796,108116,112912,-69406
"1822",2012-09-14,29635,46515,16881,-39771
"1823",2012-09-17,10908,131827,120919,-28863
"1824",2012-09-18,5222,15445,10224,-23641
"1825",2012-09-19,-3775,17701,21476,-27416
"1826",2012-09-20,-2852,135594,138447,-30268
"1827",2012-09-21,215,11994,11778,-30053
"1828",2012-09-24,6622,18056,11434,-23431
"1829",2012-09-25,-4255,10136,14391,-27686
"1830",2012-09-26,-9741,13644,23385,-37427
"1831",2012-09-27,-4042,107029,111071,-41469
"1832",2012-09-28,23823,38389,14566,-17646
"1833",2012-10-01,11203,126454,115251,-6443
"1834",2012-10-02,-1668,7490,9158,-8111
"1835",2012-10-03,-21493,12062,33556,-29604
"1836",2012-10-04,-3510,105617,109127,-33114
"1837",2012-10-05,-2968,7399,10367,-36082
"1838",2012-10-09,2437,14175,11738,-33645
"1839",2012-10-10,-15995,8043,24038,-49640
"1840",2012-10-11,-2780,109766,112546,-52420
"1841",2012-10-12,-5396,8426,13821,-57816
"1842",2012-10-15,31455,89381,57927,-26361
"1843",2012-10-16,749,11412,10663,-25612
"1844",2012-10-17,-8880,12534,21413,-34492
"1845",2012-10-18,-3100,131861,134960,-37592
"1846",2012-10-19,-2211,9906,12117,-39803
"1847",2012-10-22,3461,14162,10701,-36342
"1848",2012-10-23,-2546,8347,10893,-38888
"1849",2012-10-24,-11357,10729,22086,-50245
"1850",2012-10-25,-5474,107050,112524,-55719
"1851",2012-10-26,-1814,10609,12422,-57533
"1852",2012-10-29,4216,15595,11379,-53317
"1853",2012-10-30,-6232,5218,11450,-59549
"1854",2012-10-31,56423,122065,65643,-3126
"1855",2012-11-01,-53238,102866,156104,-56364
"1856",2012-11-02,-21211,11377,32588,-77575
"1857",2012-11-05,1626,13162,11536,-75949
"1858",2012-11-06,-5518,5155,10673,-81467
"1859",2012-11-07,2345,12268,9923,-79122
"1860",2012-11-08,20722,131251,110529,-58400
"1861",2012-11-09,-5069,7634,12703,-63469
"1862",2012-11-13,991,14505,13514,-62478
"1863",2012-11-14,-13754,9587,23341,-76232
"1864",2012-11-15,-3485,236767,240252,-79717
"1865",2012-11-16,3393,13592,10198,-76324
"1866",2012-11-19,1539,12973,11434,-74785
"1867",2012-11-20,-4894,6937,11832,-79679
"1868",2012-11-21,-7773,14134,21907,-87452
"1869",2012-11-23,17874,130380,112506,-69578
"1870",2012-11-26,2521,13427,10906,-67057
"1871",2012-11-27,-9020,5789,14809,-76077
"1872",2012-11-28,-10911,10565,21476,-86988
"1873",2012-11-29,10504,107575,97071,-76484
"1874",2012-11-30,22340,123257,100917,-54144
"1875",2012-12-03,-24964,25390,50354,-79108
"1876",2012-12-04,-4861,6172,11033,-83969
"1877",2012-12-05,2310,12605,10296,-81659
"1878",2012-12-06,21981,131179,109198,-59678
"1879",2012-12-07,-3934,8312,12246,-63612
"1880",2012-12-10,2131,13987,11856,-61481
"1881",2012-12-11,-3597,7711,11308,-65078
"1882",2012-12-12,-6612,13824,20436,-71690
"1883",2012-12-13,-2413,134708,137120,-74103
"1884",2012-12-14,9819,42568,32749,-64284
"1885",2012-12-17,45339,132773,87434,-18945
"1886",2012-12-18,-3809,6423,10232,-22754
"1887",2012-12-19,-5319,15979,21298,-28073
"1888",2012-12-20,-25218,111381,136599,-53291
"1889",2012-12-21,2298,18835,16538,-50993
"1890",2012-12-24,11488,22434,10946,-39505
"1891",2012-12-26,-7907,8617,16524,-47412
"1892",2012-12-27,-930,115344,116274,-48342
"1893",2012-12-28,4017,18479,14463,-44325
"1894",2012-12-31,33955,144499,110545,-10370
"1895",2013-01-02,-8262,31675,39938,-18632
"1896",2013-01-03,-21668,114416,136085,-40300
"1897",2013-01-04,-676,14138,14814,-40976
"1898",2013-01-07,1757,14440,12683,-39219
"1899",2013-01-08,-6702,7035,13737,-45921
"1900",2013-01-09,-9830,10757,20587,-55751
"1901",2013-01-10,-4701,131290,135991,-60452
"1902",2013-01-11,1034,10630,9597,-59418
"1903",2013-01-14,6603,18424,11821,-52815
"1904",2013-01-15,26764,88151,61387,-26051
"1905",2013-01-16,139,21438,21298,-25912
"1906",2013-01-17,-7743,104688,112431,-33655
"1907",2013-01-18,-425,15006,15431,-34080
"1908",2013-01-22,9729,23288,13558,-24351
"1909",2013-01-23,2504,26888,24384,-21847
"1910",2013-01-24,-11456,102297,113752,-33303
"1911",2013-01-25,250,11061,10811,-33053
"1912",2013-01-28,5419,15834,10415,-27634
"1913",2013-01-29,-4223,6597,10820,-31857
